Flight Name,Expected Takeoff Time,Actual Takeoff Time,Delay Time,Flight Time,Airline,Departure Airport,Arrival Airport
DL192,1682959659,1682968675,9016,7548,Delta Air Lines,SFO,ORD
DL192,1682979941,1682980977,1036,20094,Delta Air Lines,ORD,MKE
DL192,1683008638,1683010432,1794,19455,Delta Air Lines,MKE,LAX
DL192,1683039934,1683047577,7643,12460,Delta Air Lines,LAX,ORD
DL192,1683070129,1683070738,609,12755,Delta Air Lines,ORD,MKE
DL192,1683087272,1683091441,4169,17225,Delta Air Lines,MKE,ORD
DL192,1683114721,1683116142,1421,15259,Delta Air Lines,ORD,MKE
DL192,1683134660,1683135955,1295,20916,Delta Air Lines,MKE,LAX
DL192,1683161908,1683170673,8765,12438,Delta Air Lines,LAX,ORD
DL192,1683189220,1683190017,797,10238,Delta Air Lines,ORD,MKE
DL192,1683205963,1683209505,3542,5468,Delta Air Lines,MKE,ORD
DL192,1683223780,1683224628,848,19707,Delta Air Lines,ORD,MKE
DL192,1683254864,1683255876,1012,19074,Delta Air Lines,MKE,LAX
DL192,1683275372,1683276613,1241,6209,Delta Air Lines,LAX,SFO
DL192,1683286380,1683288019,1639,20339,Delta Air Lines,SFO,LAX
DL192,1683309596,1683310051,455,13656,Delta Air Lines,LAX,SFO
DL192,1683325600,1683326256,656,13811,Delta Air Lines,SFO,LAX
DL192,1683344568,1683351779,7211,15360,Delta Air Lines,LAX,ORD
DL192,1683367871,1683368433,562,16247,Delta Air Lines,ORD,MKE
DL192,1683393226,1683393560,334,3673,Delta Air Lines,MKE,LAX
DL192,1683403010,1683403277,267,14381,Delta Air Lines,LAX,SFO
DL192,1683427845,1683428689,844,12121,Delta Air Lines,SFO,LAX
DL192,1683446843,1683448259,1416,11760,Delta Air Lines,LAX,SFO
DL192,1683463729,1683465131,1402,15804,Delta Air Lines,SFO,LAX
DL192,1683489492,1683491248,1756,19908,Delta Air Lines,LAX,SFO
DL192,1683521013,1683522789,1776,6526,Delta Air Lines,SFO,LAX
DL192,1683531637,1683533165,1528,9017,Delta Air Lines,LAX,SFO
DL192,1683551483,1683553177,1694,4681,Delta Air Lines,SFO,LAX
DL192,1683561067,1683569582,8515,8113,Delta Air Lines,LAX,ORD
DL192,1683587232,1683588121,889,16501,Delta Air Lines,ORD,MKE
DL192,1683606529,1683608051,1522,21178,Delta Air Lines,MKE,LAX
DL192,1683639277,1683639922,645,16304,Delta Air Lines,LAX,SFO
DL192,1683658116,1683665231,7115,11914,Delta Air Lines,SFO,ORD
DL192,1683680904,1683681321,417,20597,Delta Air Lines,ORD,MKE
DL192,1683705078,1683706869,1791,18951,Delta Air Lines,MKE,LAX
DL192,1683732927,1683734421,1494,10789,Delta Air Lines,LAX,SFO
DL192,1683755976,1683762165,6189,12120,Delta Air Lines,SFO,ORD
DL192,1683779831,1683780834,1003,14616,Delta Air Lines,ORD,MKE
DL192,1683797888,1683798630,742,10214,Delta Air Lines,MKE,LAX
DL192,1683813645,1683823241,9596,6876,Delta Air Lines,LAX,ORD
DL192,1683834951,1683835347,396,7055,Delta Air Lines,ORD,MKE
DL192,1683842625,1683842954,329,15501,Delta Air Lines,MKE,LAX
DL192,1683867133,1683871770,4637,18310,Delta Air Lines,LAX,ORD
DL192,1683898559,1683899898,1339,20526,Delta Air Lines,ORD,MKE
DL192,1683927287,1683928595,1308,10609,Delta Air Lines,MKE,SFO
DL192,1683944027,1683947962,3935,21497,Delta Air Lines,SFO,ORD
DL192,1683974393,1683974411,18,12467,Delta Air Lines,ORD,MKE
DL192,1683988751,1683998963,10212,4375,Delta Air Lines,MKE,ORD
DL192,1684007406,1684008105,699,15400,Delta Air Lines,ORD,MKE
DL192,1684029788,1684030680,892,4638,Delta Air Lines,MKE,SFO
DL192,1684043489,1684051714,8225,14823,Delta Air Lines,SFO,ORD
DL192,1684072159,1684073904,1745,18101,Delta Air Lines,ORD,MKE
DL192,1684101073,1684109824,8751,12333,Delta Air Lines,MKE,ORD
DL192,1684129344,1684130043,699,18347,Delta Air Lines,ORD,MKE
DL192,1684149763,1684150503,740,9089,Delta Air Lines,MKE,SFO
DL192,1684164244,1684165085,841,17982,Delta Air Lines,SFO,LAX
DL192,1684185471,1684188355,2884,13264,Delta Air Lines,LAX,ORD
DL192,1684209015,1684209704,689,8524,Delta Air Lines,ORD,MKE
DL192,1684220174,1684221640,1466,19156,Delta Air Lines,MKE,SFO
DL192,1684245173,1684245451,278,12121,Delta Air Lines,SFO,LAX
DL192,1684260451,1684261947,1496,20276,Delta Air Lines,LAX,SFO
DL192,1684286578,1684287271,693,19433,Delta Air Lines,SFO,LAX
DL192,1684308308,1684314282,5974,12313,Delta Air Lines,LAX,ORD
DL192,1684333745,1684335438,1693,18556,Delta Air Lines,ORD,MKE
DL192,1684359851,1684360087,236,13652,Delta Air Lines,MKE,LAX
DL192,1684377353,1684379617,2264,20326,Delta Air Lines,LAX,ORD
DL192,1684406459,1684408217,1758,15495,Delta Air Lines,ORD,MKE
DL192,1684433479,1684444265,10786,6830,Delta Air Lines,MKE,ORD
DL192,1684461746,1684461908,162,11113,Delta Air Lines,ORD,MKE
DL192,1684478207,1684478331,124,19244,Delta Air Lines,MKE,LAX
DL192,1684502036,1684503779,1743,4112,Delta Air Lines,LAX,SFO
DL192,1684511855,1684519797,7942,8179,Delta Air Lines,SFO,ORD
DL192,1684537981,1684539602,1621,16694,Delta Air Lines,ORD,MKE
DL192,1684565822,1684565870,48,15489,Delta Air Lines,MKE,SFO
DL192,1684583623,1684585194,1571,15414,Delta Air Lines,SFO,LAX
DL192,1684607593,1684608649,1056,13636,Delta Air Lines,LAX,SFO
DL192,1684632960,1684638176,5216,9144,Delta Air Lines,SFO,ORD
DL192,1684655975,1684657674,1699,11606,Delta Air Lines,ORD,MKE
DL192,1684672227,1684676133,3906,17798,Delta Air Lines,MKE,ORD
DL192,1684703878,1684704508,630,9238,Delta Air Lines,ORD,MKE
DL192,1684722122,1684722990,868,16841,Delta Air Lines,MKE,LAX
DL192,1684750607,1684751539,932,21491,Delta Air Lines,LAX,SFO
DL192,1684779877,1684780661,784,20192,Delta Air Lines,SFO,LAX
DL192,1684810226,1684812404,2178,21101,Delta Air Lines,LAX,ORD
DL192,1684840159,1684841257,1098,10985,Delta Air Lines,ORD,MKE
DL192,1684859445,1684860578,1133,8017,Delta Air Lines,MKE,SFO
DL192,1684869131,1684875649,6518,14348,Delta Air Lines,SFO,ORD
DL192,1684894830,1684896148,1318,11986,Delta Air Lines,ORD,MKE
DL192,1684917185,1684918613,1428,5258,Delta Air Lines,MKE,LAX
DL192,1684926218,1684932124,5906,16626,Delta Air Lines,LAX,ORD
DL192,1684949304,1684949804,500,21124,Delta Air Lines,ORD,MKE
DL192,1684981714,1684982031,317,11922,Delta Air Lines,MKE,LAX
DL192,1684993955,1684994771,816,17781,Delta Air Lines,LAX,SFO
DL192,1685015216,1685015340,124,6691,Delta Air Lines,SFO,LAX
DL192,1685027617,1685035989,8372,12138,Delta Air Lines,LAX,ORD
DL192,1685051015,1685052230,1215,4097,Delta Air Lines,ORD,MKE
DL192,1685062604,1685065617,3013,20812,Delta Air Lines,MKE,ORD
DL192,1685091768,1685092982,1214,5964,Delta Air Lines,ORD,MKE
DL192,1685099898,1685100039,141,4992,Delta Air Lines,MKE,LAX
DL192,1685109930,1685109958,28,7536,Delta Air Lines,LAX,SFO
DL192,1685124078,1685124377,299,20730,Delta Air Lines,SFO,LAX
DL192,1685153176,1685161101,7925,18056,Delta Air Lines,LAX,ORD
DL192,1685181584,1685182286,702,10599,Delta Air Lines,ORD,MKE
DL192,1685198861,1685199424,563,20427,Delta Air Lines,MKE,LAX
DL192,1685223528,1685225112,1584,4634,Delta Air Lines,LAX,SFO
DL192,1685231432,1685238091,6659,6716,Delta Air Lines,SFO,ORD
DL192,1685248669,1685249761,1092,9172,Delta Air Lines,ORD,MKE
DL192,1685267090,1685267274,184,13213,Delta Air Lines,MKE,LAX
DL192,1685283806,1685284999,1193,3723,Delta Air Lines,LAX,SFO
DL192,1685289780,1685298483,8703,12243,Delta Air Lines,SFO,ORD
DL192,1685314044,1685315550,1506,5384,Delta Air Lines,ORD,MKE
DL192,1685326951,1685327599,648,15568,Delta Air Lines,MKE,SFO
DL192,1685345115,1685346839,1724,20640,Delta Air Lines,SFO,LAX
DL192,1685373791,1685374094,303,4718,Delta Air Lines,LAX,SFO
DL192,1685388222,1685389402,1180,18939,Delta Air Lines,SFO,LAX
DL192,1685408826,1685417082,8256,20937,Delta Air Lines,LAX,ORD
DL192,1685439183,1685440531,1348,18970,Delta Air Lines,ORD,MKE
DL192,1685462773,1685466930,4157,20655,Delta Air Lines,MKE,ORD
DL192,1685488077,1685489546,1469,16807,Delta Air Lines,ORD,MKE
DL192,1685515480,1685516556,1076,15000,Delta Air Lines,MKE,SFO
DL192,1685534487,1685540392,5905,18203,Delta Air Lines,SFO,ORD
DL192,1685563247,1685563344,97,8979,Delta Air Lines,ORD,MKE
DL192,1685576007,1685576490,483,20627,Delta Air Lines,MKE,LAX
DL192,1685599411,1685600186,775,4717,Delta Air Lines,LAX,SFO
DL192,1685607072,1685607878,806,3882,Delta Air Lines,SFO,LAX
DL192,1685618114,1685619765,1651,17803,Delta Air Lines,LAX,SFO
DL192,1685640343,1685641399,1056,16501,Delta Air Lines,SFO,LAX
DL192,1685667218,1685667722,504,13489,Delta Air Lines,LAX,SFO
DL192,1685681480,1685683278,1798,20570,Delta Air Lines,SFO,LAX
DL192,1685706165,1685708221,2056,3780,Delta Air Lines,LAX,ORD
DL192,1685720659,1685722458,1799,5508,Delta Air Lines,ORD,MKE
DL192,1685730901,1685731227,326,5674,Delta Air Lines,MKE,SFO
DL192,1685744506,1685748373,3867,9298,Delta Air Lines,SFO,ORD
DL192,1685763623,1685764275,652,21571,Delta Air Lines,ORD,MKE
DL192,1685787948,1685788864,916,14522,Delta Air Lines,MKE,LAX
DL192,1685811283,1685812456,1173,14636,Delta Air Lines,LAX,SFO
DL192,1685828120,1685829870,1750,12362,Delta Air Lines,SFO,LAX
DL192,1685844544,1685845999,1455,17237,Delta Air Lines,LAX,SFO
DL192,1685863970,1685865090,1120,11455,Delta Air Lines,SFO,LAX
DL192,1685887329,1685892463,5134,15070,Delta Air Lines,LAX,ORD
DL192,1685911704,1685912834,1130,19251,Delta Air Lines,ORD,MKE
DL192,1685935212,1685940673,5461,5273,Delta Air Lines,MKE,ORD
DL192,1685946681,1685947732,1051,12542,Delta Air Lines,ORD,MKE
DL192,1685966305,1685967578,1273,5641,Delta Air Lines,MKE,SFO
DL192,1685980977,1685982614,1637,5552,Delta Air Lines,SFO,LAX
DL192,1685998117,1685999037,920,13612,Delta Air Lines,LAX,SFO
DL192,1686018514,1686019614,1100,4620,Delta Air Lines,SFO,LAX
DL192,1686031419,1686036383,4964,4362,Delta Air Lines,LAX,ORD
DL192,1686046345,1686046350,5,10588,Delta Air Lines,ORD,MKE
DL192,1686060782,1686061170,388,13170,Delta Air Lines,MKE,LAX
DL192,1686084918,1686090856,5938,14947,Delta Air Lines,LAX,ORD
DL192,1686106543,1686107517,974,11458,Delta Air Lines,ORD,MKE
DL192,1686126032,1686127406,1374,10156,Delta Air Lines,MKE,LAX
DL192,1686138281,1686146754,8473,9369,Delta Air Lines,LAX,ORD
DL192,1686165888,1686166545,657,14596,Delta Air Lines,ORD,MKE
DL192,1686188213,1686198762,10549,18313,Delta Air Lines,MKE,ORD
DL192,1686220972,1686221937,965,6540,Delta Air Lines,ORD,MKE
DL192,1686235975,1686244918,8943,8223,Delta Air Lines,MKE,ORD
DL192,1686257796,1686259276,1480,20109,Delta Air Lines,ORD,MKE
DL192,1686283888,1686284977,1089,11926,Delta Air Lines,MKE,SFO
DL192,1686305976,1686315197,9221,7507,Delta Air Lines,SFO,ORD
DL192,1686326349,1686326377,28,12020,Delta Air Lines,ORD,MKE
DL192,1686346876,1686354055,7179,4097,Delta Air Lines,MKE,ORD
DL192,1686360649,1686361562,913,20577,Delta Air Lines,ORD,MKE
DL192,1686389037,1686389932,895,16943,Delta Air Lines,MKE,SFO
DL192,1686417306,1686417946,640,12269,Delta Air Lines,SFO,LAX
DL192,1686435354,1686437072,1718,7004,Delta Air Lines,LAX,SFO
DL192,1686449051,1686456321,7270,17503,Delta Air Lines,SFO,ORD
DL192,1686481551,1686481907,356,19343,Delta Air Lines,ORD,MKE
DL192,1686510469,1686511012,543,6625,Delta Air Lines,MKE,SFO
DL192,1686521765,1686523003,1238,17046,Delta Air Lines,SFO,LAX
DL192,1686546067,1686555104,9037,21584,Delta Air Lines,LAX,ORD
DL192,1686583481,1686583992,511,3993,Delta Air Lines,ORD,MKE
DL192,1686596696,1686597611,915,21169,Delta Air Lines,MKE,LAX
DL192,1686625761,1686626067,306,7252,Delta Air Lines,LAX,SFO
DL192,1686637753,1686639260,1507,4396,Delta Air Lines,SFO,LAX
DL192,1686653530,1686656158,2628,21522,Delta Air Lines,LAX,ORD
DL192,1686681046,1686681591,545,5148,Delta Air Lines,ORD,MKE
DL192,1686689381,1686689434,53,19506,Delta Air Lines,MKE,SFO
DL192,1686719167,1686720565,1398,20417,Delta Air Lines,SFO,LAX
DL192,1686743217,1686750236,7019,17617,Delta Air Lines,LAX,ORD
DL192,1686769574,1686770863,1289,4498,Delta Air Lines,ORD,MKE
DL192,1686777321,1686783308,5987,3606,Delta Air Lines,MKE,ORD
DL192,1686795996,1686797576,1580,4758,Delta Air Lines,ORD,MKE
DL192,1686810601,1686817875,7274,18253,Delta Air Lines,MKE,ORD
DL192,1686843145,1686843921,776,15284,Delta Air Lines,ORD,MKE
DL192,1686861130,1686862342,1212,10151,Delta Air Lines,MKE,LAX
DL192,1686882719,1686891311,8592,6819,Delta Air Lines,LAX,ORD
DL192,1686903173,1686904132,959,7643,Delta Air Lines,ORD,MKE
DL192,1686919381,1686920174,793,16114,Delta Air Lines,MKE,SFO
DL192,1686942200,1686945974,3774,5916,Delta Air Lines,SFO,ORD
DL192,1686956127,1686957696,1569,11951,Delta Air Lines,ORD,MKE
DL192,1686972743,1686973286,543,8913,Delta Air Lines,MKE,LAX
DL192,1686983349,1686992656,9307,16486,Delta Air Lines,LAX,ORD
DL192,1687011004,1687012626,1622,6092,Delta Air Lines,ORD,MKE
DL192,1687022113,1687022186,73,18117,Delta Air Lines,MKE,SFO
DL192,1687040884,1687048114,7230,7870,Delta Air Lines,SFO,ORD
DL192,1687057489,1687058967,1478,16557,Delta Air Lines,ORD,MKE
DL192,1687085963,1687087656,1693,4393,Delta Air Lines,MKE,LAX
DL192,1687099349,1687103522,4173,19136,Delta Air Lines,LAX,ORD
DL192,1687122851,1687124087,1236,7193,Delta Air Lines,ORD,MKE
DL192,1687138580,1687140161,1581,15094,Delta Air Lines,MKE,LAX
DL192,1687165941,1687170613,4672,20065,Delta Air Lines,LAX,ORD
DL192,1687194770,1687195823,1053,20472,Delta Air Lines,ORD,MKE
DL192,1687220875,1687222571,1696,7478,Delta Air Lines,MKE,SFO
DL192,1687231535,1687236807,5272,12146,Delta Air Lines,SFO,ORD
DL192,1687259184,1687259470,286,5211,Delta Air Lines,ORD,MKE
DL192,1687267853,1687267857,4,7444,Delta Air Lines,MKE,SFO
DL192,1687279599,1687281173,1574,9153,Delta Air Lines,SFO,LAX
DL192,1687292377,1687295761,3384,15998,Delta Air Lines,LAX,ORD
DL192,1687320874,1687322597,1723,5918,Delta Air Lines,ORD,MKE
DL192,1687332292,1687333505,1213,4779,Delta Air Lines,MKE,LAX
DL192,1687343369,1687344047,678,9654,Delta Air Lines,LAX,SFO
DL192,1687362905,1687373607,10702,15611,Delta Air Lines,SFO,ORD
DL192,1687390011,1687390936,925,19983,Delta Air Lines,ORD,MKE
DL192,1687411340,1687412696,1356,7739,Delta Air Lines,MKE,LAX
DL192,1687424849,1687425937,1088,5826,Delta Air Lines,LAX,SFO
DL192,1687441895,1687443382,1487,6287,Delta Air Lines,SFO,LAX
DL192,1687456768,1687458493,1725,4975,Delta Air Lines,LAX,SFO
DL192,1687470989,1687478963,7974,16576,Delta Air Lines,SFO,ORD
DL192,1687500354,1687501469,1115,5387,Delta Air Lines,ORD,MKE
DL192,1687508965,1687512232,3267,20340,Delta Air Lines,MKE,ORD
DL192,1687535645,1687536658,1013,10857,Delta Air Lines,ORD,MKE
DL192,1687547559,1687551718,4159,17555,Delta Air Lines,MKE,ORD
DL192,1687576802,1687577104,302,13381,Delta Air Lines,ORD,MKE
DL192,1687593332,1687602658,9326,18061,Delta Air Lines,MKE,ORD
DL192,1687625170,1687625653,483,18164,Delta Air Lines,ORD,MKE
DL192,1687651420,1687658444,7024,17378,Delta Air Lines,MKE,ORD
DL192,1687684379,1687684494,115,17094,Delta Air Lines,ORD,MKE
DL192,1687704857,1687705575,718,8228,Delta Air Lines,MKE,LAX
DL192,1687721290,1687724166,2876,10276,Delta Air Lines,LAX,ORD
DL192,1687739039,1687740355,1316,16496,Delta Air Lines,ORD,MKE
DL192,1687766404,1687767405,1001,15952,Delta Air Lines,MKE,LAX
DL192,1687785554,1687786010,456,16216,Delta Air Lines,LAX,SFO
DL192,1687810096,1687815861,5765,6424,Delta Air Lines,SFO,ORD
DL192,1687828236,1687829292,1056,7874,Delta Air Lines,ORD,MKE
DL192,1687837369,1687838787,1418,12036,Delta Air Lines,MKE,LAX
DL192,1687859460,1687859875,415,17024,Delta Air Lines,LAX,SFO
DL192,1687877085,1687877801,716,14753,Delta Air Lines,SFO,LAX
DL192,1687902869,1687911027,8158,10941,Delta Air Lines,LAX,ORD
DL192,1687922149,1687922776,627,11685,Delta Air Lines,ORD,MKE
DL192,1687937685,1687938339,654,10084,Delta Air Lines,MKE,SFO
DL192,1687948988,1687950391,1403,19892,Delta Air Lines,SFO,LAX
DL192,1687980516,1687980547,31,14263,Delta Air Lines,LAX,SFO
DL192,1688004243,1688005087,844,7199,Delta Air Lines,SFO,LAX
DL192,1688018201,1688018511,310,12987,Delta Air Lines,LAX,SFO
DL192,1688039516,1688048196,8680,12210,Delta Air Lines,SFO,ORD
DL192,1688067505,1688068354,849,11641,Delta Air Lines,ORD,MKE
DL192,1688085789,1688087144,1355,16637,Delta Air Lines,MKE,SFO
DL192,1688104110,1688110307,6197,18293,Delta Air Lines,SFO,ORD
DL192,1688129533,1688130556,1023,14569,Delta Air Lines,ORD,MKE
DL192,1688155924,1688156207,283,9832,Delta Air Lines,MKE,LAX
DL192,1688174256,1688180403,6147,15258,Delta Air Lines,LAX,ORD
DL192,1688204333,1688206034,1701,9968,Delta Air Lines,ORD,MKE
DL192,1688221412,1688231905,10493,12628,Delta Air Lines,MKE,ORD
DL192,1688252360,1688252451,91,13098,Delta Air Lines,ORD,MKE
DL192,1688272571,1688282828,10257,8023,Delta Air Lines,MKE,ORD
DL192,1688301467,1688302148,681,4525,Delta Air Lines,ORD,MKE
DL192,1688307083,1688308841,1758,12327,Delta Air Lines,MKE,LAX
DL192,1688322176,1688323660,1484,6016,Delta Air Lines,LAX,SFO
DL192,1688329684,1688330888,1204,11370,Delta Air Lines,SFO,LAX
DL192,1688344751,1688347004,2253,10916,Delta Air Lines,LAX,ORD
DL192,1688367681,1688369154,1473,16560,Delta Air Lines,ORD,MKE
DL192,1688390487,1688391409,922,18449,Delta Air Lines,MKE,SFO
DL192,1688417638,1688418184,546,15795,Delta Air Lines,SFO,LAX
DL192,1688436492,1688437653,1161,21440,Delta Air Lines,LAX,SFO
DL192,1688459469,1688459624,155,13371,Delta Air Lines,SFO,LAX
DL192,1688478512,1688487153,8641,6436,Delta Air Lines,LAX,ORD
DL192,1688496084,1688497130,1046,11498,Delta Air Lines,ORD,MKE
DL192,1688512932,1688514016,1084,8398,Delta Air Lines,MKE,SFO
DL192,1688526904,1688528445,1541,6714,Delta Air Lines,SFO,LAX
DL192,1688543228,1688550422,7194,20365,Delta Air Lines,LAX,ORD
DL192,1688575937,1688577678,1741,19674,Delta Air Lines,ORD,MKE
DL192,1688603889,1688604329,440,17210,Delta Air Lines,MKE,SFO
DL192,1688623586,1688624127,541,6850,Delta Air Lines,SFO,LAX
DL192,1688631955,1688632039,84,10689,Delta Air Lines,LAX,SFO
DL192,1688645185,1688646789,1604,5900,Delta Air Lines,SFO,LAX
DL192,1688660246,1688669054,8808,8178,Delta Air Lines,LAX,ORD
DL192,1688682126,1688682214,88,14794,Delta Air Lines,ORD,MKE
DL192,1688707215,1688716704,9489,3761,Delta Air Lines,MKE,ORD
DL192,1688722146,1688723779,1633,12402,Delta Air Lines,ORD,MKE
DL192,1688739460,1688745268,5808,8014,Delta Air Lines,MKE,ORD
DL192,1688755810,1688756404,594,13455,Delta Air Lines,ORD,MKE
DL192,1688778974,1688780024,1050,14063,Delta Air Lines,MKE,LAX
DL192,1688796013,1688797376,1363,18006,Delta Air Lines,LAX,SFO
DL192,1688826106,1688829038,2932,15276,Delta Air Lines,SFO,ORD
DL192,1688854437,1688854840,403,7179,Delta Air Lines,ORD,MKE
DL192,1688863217,1688864164,947,3950,Delta Air Lines,MKE,SFO
DL192,1688873895,1688878079,4184,9942,Delta Air Lines,SFO,ORD
DL192,1688894821,1688895359,538,14215,Delta Air Lines,ORD,MKE
DL192,1688915393,1688915843,450,14443,Delta Air Lines,MKE,SFO
DL192,1688936236,1688936422,186,17222,Delta Air Lines,SFO,LAX
DL192,1688955732,1688964887,9155,20062,Delta Air Lines,LAX,ORD
DL192,1688995679,1688997200,1521,8601,Delta Air Lines,ORD,MKE
DL192,1689005808,1689007064,1256,8416,Delta Air Lines,MKE,LAX
DL192,1689021009,1689021658,649,17407,Delta Air Lines,LAX,SFO
DL192,1689042636,1689043962,1326,15763,Delta Air Lines,SFO,LAX
DL192,1689063384,1689065864,2480,13136,Delta Air Lines,LAX,ORD
DL192,1689086652,1689088276,1624,20021,Delta Air Lines,ORD,MKE
DL192,1689111528,1689111549,21,16023,Delta Air Lines,MKE,LAX
DL192,1689129770,1689133010,3240,5554,Delta Air Lines,LAX,ORD
DL192,1689147258,1689147813,555,12578,Delta Air Lines,ORD,MKE
DL192,1689160559,1689161804,1245,17916,Delta Air Lines,MKE,SFO
DL192,1689184781,1689185454,673,15175,Delta Air Lines,SFO,LAX
DL192,1689205199,1689210293,5094,9334,Delta Air Lines,LAX,ORD
DL192,1689230026,1689230765,739,12234,Delta Air Lines,ORD,MKE
DL192,1689243607,1689245647,2040,20004,Delta Air Lines,MKE,ORD
DL192,1689276305,1689277345,1040,10704,Delta Air Lines,ORD,MKE
DL192,1689295334,1689295953,619,11539,Delta Air Lines,MKE,SFO
DL192,1689310116,1689311469,1353,14510,Delta Air Lines,SFO,LAX
DL192,1689326241,1689333909,7668,14468,Delta Air Lines,LAX,ORD
DL192,1689349611,1689350318,707,13567,Delta Air Lines,ORD,MKE
DL192,1689372127,1689372522,395,11531,Delta Air Lines,MKE,LAX
DL192,1689384487,1689384941,454,16732,Delta Air Lines,LAX,SFO
DL192,1689404710,1689404886,176,14561,Delta Air Lines,SFO,LAX
DL192,1689426859,1689429837,2978,15852,Delta Air Lines,LAX,ORD
DL192,1689453451,1689454870,1419,5440,Delta Air Lines,ORD,MKE
DL192,1689463375,1689464213,838,5947,Delta Air Lines,MKE,SFO
DL192,1689475308,1689476496,1188,13636,Delta Air Lines,SFO,LAX
DL192,1689492489,1689493927,1438,6639,Delta Air Lines,LAX,SFO
DL192,1689502222,1689504532,2310,5317,Delta Air Lines,SFO,ORD
DL192,1689515378,1689517148,1770,5425,Delta Air Lines,ORD,MKE
DL192,1689523478,1689533546,10068,15038,Delta Air Lines,MKE,ORD
DL192,1689549039,1689550052,1013,6369,Delta Air Lines,ORD,MKE
DL192,1689562464,1689563845,1381,11839,Delta Air Lines,MKE,LAX
DL192,1689586117,1689589240,3123,8007,Delta Air Lines,LAX,ORD
DL192,1689599640,1689600655,1015,10726,Delta Air Lines,ORD,MKE
DL192,1689611823,1689612141,318,15688,Delta Air Lines,MKE,SFO
DL192,1689630772,1689633999,3227,15597,Delta Air Lines,SFO,ORD
DL192,1689655578,1689655971,393,11866,Delta Air Lines,ORD,MKE
DL192,1689671589,1689671636,47,7288,Delta Air Lines,MKE,SFO
DL192,1689683492,1689683745,253,12031,Delta Air Lines,SFO,LAX
DL192,1689702610,1689704164,1554,20360,Delta Air Lines,LAX,SFO
DL192,1689730865,1689733508,2643,12761,Delta Air Lines,SFO,ORD
DL192,1689751622,1689752178,556,10143,Delta Air Lines,ORD,MKE
DL192,1689768899,1689775876,6977,20007,Delta Air Lines,MKE,ORD
DL192,1689798613,1689799104,491,21555,Delta Air Lines,ORD,MKE
DL192,1689827456,1689827593,137,6937,Delta Air Lines,MKE,SFO
DL192,1689843444,1689844246,802,16373,Delta Air Lines,SFO,LAX
DL192,1689863948,1689865002,1054,12364,Delta Air Lines,LAX,SFO
DL192,1689886501,1689887408,907,3721,Delta Air Lines,SFO,LAX
DL192,1689899928,1689907055,7127,4657,Delta Air Lines,LAX,ORD
DL192,1689912060,1689913186,1126,16615,Delta Air Lines,ORD,MKE
DL192,1689934794,1689935352,558,12433,Delta Air Lines,MKE,SFO
DL192,1689951170,1689951364,194,7086,Delta Air Lines,SFO,LAX
DL192,1689962828,1689963457,629,21566,Delta Air Lines,LAX,SFO
DL192,1689994267,1689995822,1555,5204,Delta Air Lines,SFO,LAX
DL192,1690009273,1690009367,94,14102,Delta Air Lines,LAX,SFO
DL192,1690033131,1690034117,986,17151,Delta Air Lines,SFO,LAX
DL192,1690057265,1690057780,515,13387,Delta Air Lines,LAX,SFO
DL192,1690078752,1690085366,6614,20369,Delta Air Lines,SFO,ORD
DL192,1690111432,1690111620,188,17388,Delta Air Lines,ORD,MKE
DL192,1690134481,1690135558,1077,7004,Delta Air Lines,MKE,SFO
DL192,1690148682,1690150391,1709,4468,Delta Air Lines,SFO,LAX
DL192,1690163550,1690166556,3006,4846,Delta Air Lines,LAX,ORD
DL192,1690172058,1690172629,571,19517,Delta Air Lines,ORD,MKE
DL192,1690193928,1690201267,7339,19002,Delta Air Lines,MKE,ORD
DL192,1690222122,1690222555,433,17306,Delta Air Lines,ORD,MKE
DL192,1690242518,1690247052,4534,8217,Delta Air Lines,MKE,ORD
DL192,1690259067,1690260141,1074,19046,Delta Air Lines,ORD,MKE
DL192,1690286112,1690287580,1468,13237,Delta Air Lines,MKE,LAX
DL192,1690305826,1690306488,662,7244,Delta Air Lines,LAX,SFO
DL192,1690314341,1690319308,4967,4956,Delta Air Lines,SFO,ORD
DL192,1690333666,1690334878,1212,14026,Delta Air Lines,ORD,MKE
DL192,1690355193,1690356903,1710,6471,Delta Air Lines,MKE,SFO
DL192,1690370002,1690372337,2335,21079,Delta Air Lines,SFO,ORD
DL192,1690403438,1690404358,920,12847,Delta Air Lines,ORD,MKE
DL192,1690417667,1690418397,730,11851,Delta Air Lines,MKE,LAX
DL192,1690436191,1690436598,407,9776,Delta Air Lines,LAX,SFO
DL192,1690453732,1690457140,3408,7990,Delta Air Lines,SFO,ORD
DL192,1690468571,1690469742,1171,20507,Delta Air Lines,ORD,MKE
DL192,1690490277,1690491840,1563,10990,Delta Air Lines,MKE,LAX
DL192,1690513323,1690524097,10774,18509,Delta Air Lines,LAX,ORD
DL192,1690551814,1690552599,785,6189,Delta Air Lines,ORD,MKE
DL192,1690561199,1690561826,627,14802,Delta Air Lines,MKE,LAX
DL192,1690583618,1690584127,509,15229,Delta Air Lines,LAX,SFO
DL192,1690599740,1690601416,1676,12655,Delta Air Lines,SFO,LAX
DL192,1690622469,1690623607,1138,18089,Delta Air Lines,LAX,SFO
DL192,1690652401,1690659865,7464,21100,Delta Air Lines,SFO,ORD
DL192,1690683717,1690685342,1625,15438,Delta Air Lines,ORD,MKE
DL192,1690705510,1690706443,933,15222,Delta Air Lines,MKE,SFO
DL192,1690728775,1690733477,4702,11966,Delta Air Lines,SFO,ORD
DL192,1690753945,1690755034,1089,14723,Delta Air Lines,ORD,MKE
DL192,1690775045,1690775244,199,8353,Delta Air Lines,MKE,LAX
DL192,1690793050,1690793592,542,6816,Delta Air Lines,LAX,SFO
DL192,1690801251,1690811264,10013,6792,Delta Air Lines,SFO,ORD
DL192,1690828633,1690828739,106,5553,Delta Air Lines,ORD,MKE
DL192,1690836517,1690836654,137,16323,Delta Air Lines,MKE,SFO
DL192,1690856210,1690857602,1392,7579,Delta Air Lines,SFO,LAX
DL192,1690866335,1690876697,10362,12051,Delta Air Lines,LAX,ORD
DL192,1690898492,1690899878,1386,13672,Delta Air Lines,ORD,MKE
DL192,1690917918,1690919545,1627,15907,Delta Air Lines,MKE,SFO
DL192,1690944739,1690946531,1792,20177,Delta Air Lines,SFO,LAX
DL192,1690969875,1690976599,6724,8766,Delta Air Lines,LAX,ORD
DL192,1690989668,1690990484,816,19789,Delta Air Lines,ORD,MKE
DL192,1691019047,1691019261,214,17224,Delta Air Lines,MKE,SFO
DL192,1691038240,1691039326,1086,15343,Delta Air Lines,SFO,LAX
DL192,1691054885,1691058524,3639,17984,Delta Air Lines,LAX,ORD
DL192,1691077190,1691077307,117,21537,Delta Air Lines,ORD,MKE
DL192,1691103037,1691103354,317,5743,Delta Air Lines,MKE,LAX
DL192,1691113975,1691117827,3852,7427,Delta Air Lines,LAX,ORD
DL192,1691129784,1691130374,590,11665,Delta Air Lines,ORD,MKE
DL192,1691151590,1691160279,8689,10982,Delta Air Lines,MKE,ORD
DL192,1691175726,1691176550,824,8402,Delta Air Lines,ORD,MKE
DL192,1691192436,1691193416,980,21471,Delta Air Lines,MKE,LAX
DL192,1691221165,1691221236,71,16051,Delta Air Lines,LAX,SFO
DL192,1691247014,1691251416,4402,21397,Delta Air Lines,SFO,ORD
DL192,1691282808,1691283753,945,20012,Delta Air Lines,ORD,MKE
DL192,1691312260,1691313727,1467,6078,Delta Air Lines,MKE,LAX
DL192,1691327652,1691330362,2710,6725,Delta Air Lines,LAX,ORD
DL192,1691344236,1691344746,510,20296,Delta Air Lines,ORD,MKE
DL192,1691368560,1691368717,157,20517,Delta Air Lines,MKE,LAX
DL192,1691398280,1691402120,3840,15190,Delta Air Lines,LAX,ORD
DL192,1691426628,1691427349,721,19326,Delta Air Lines,ORD,MKE
DL192,1691455496,1691456709,1213,21108,Delta Air Lines,MKE,LAX
DL192,1691484725,1691486329,1604,17288,Delta Air Lines,LAX,SFO
DL192,1691505159,1691505163,4,9811,Delta Air Lines,SFO,LAX
DL192,1691518439,1691521925,3486,18504,Delta Air Lines,LAX,ORD
DL192,1691547329,1691547451,122,16469,Delta Air Lines,ORD,MKE
DL192,1691570803,1691572488,1685,21296,Delta Air Lines,MKE,SFO
DL192,1691593911,1691594431,520,11887,Delta Air Lines,SFO,LAX
DL192,1691613250,1691614267,1017,16597,Delta Air Lines,LAX,SFO
DL192,1691636107,1691642844,6737,5790,Delta Air Lines,SFO,ORD
DL192,1691658820,1691658987,167,19786,Delta Air Lines,ORD,MKE
DL192,1691681885,1691685409,3524,17172,Delta Air Lines,MKE,ORD
DL192,1691707934,1691708383,449,18289,Delta Air Lines,ORD,MKE
DL192,1691733396,1691733998,602,12557,Delta Air Lines,MKE,SFO
DL192,1691753044,1691761842,8798,7984,Delta Air Lines,SFO,ORD
DL192,1691770792,1691771858,1066,15056,Delta Air Lines,ORD,MKE
DL192,1691794944,1691795321,377,5695,Delta Air Lines,MKE,SFO
DL192,1691810804,1691820064,9260,17185,Delta Air Lines,SFO,ORD
DL192,1691844500,1691845869,1369,18814,Delta Air Lines,ORD,MKE
DL192,1691868911,1691869169,258,15954,Delta Air Lines,MKE,LAX
DL192,1691895494,1691895796,302,19195,Delta Air Lines,LAX,SFO
DL192,1691919216,1691919940,724,7232,Delta Air Lines,SFO,LAX
DL192,1691936372,1691937883,1511,6532,Delta Air Lines,LAX,SFO
DL192,1691949458,1691959849,10391,15852,Delta Air Lines,SFO,ORD
DL192,1691980535,1691981223,688,20157,Delta Air Lines,ORD,MKE
DL192,1692001382,1692001844,462,9099,Delta Air Lines,MKE,SFO
DL192,1692016446,1692017322,876,17316,Delta Air Lines,SFO,LAX
DL192,1692042457,1692052480,10023,8233,Delta Air Lines,LAX,ORD
DL192,1692062638,1692062922,284,7106,Delta Air Lines,ORD,MKE
DL192,1692073156,1692081060,7904,15928,Delta Air Lines,MKE,ORD
DL192,1692098161,1692099081,920,12580,Delta Air Lines,ORD,MKE
DL192,1692113620,1692118442,4822,17423,Delta Air Lines,MKE,ORD
DL192,1692139413,1692139829,416,6845,Delta Air Lines,ORD,MKE
DL192,1692157107,1692158158,1051,8437,Delta Air Lines,MKE,SFO
DL192,1692175023,1692176802,1779,13388,Delta Air Lines,SFO,LAX
DL192,1692199192,1692199352,160,19752,Delta Air Lines,LAX,SFO
DL192,1692224060,1692231519,7459,16016,Delta Air Lines,SFO,ORD
DL192,1692248343,1692250102,1759,19389,Delta Air Lines,ORD,MKE
DL192,1692277410,1692278667,1257,15073,Delta Air Lines,MKE,LAX
DL192,1692301684,1692311101,9417,14405,Delta Air Lines,LAX,ORD
DL192,1692331790,1692332978,1188,8059,Delta Air Lines,ORD,MKE
DL192,1692341807,1692342166,359,7727,Delta Air Lines,MKE,LAX
DL192,1692359464,1692361055,1591,18731,Delta Air Lines,LAX,SFO
DL192,1692385430,1692386072,642,21515,Delta Air Lines,SFO,LAX
DL192,1692409175,1692409745,570,17487,Delta Air Lines,LAX,SFO
DL192,1692427445,1692431068,3623,14920,Delta Air Lines,SFO,ORD
DL192,1692447995,1692449279,1284,10276,Delta Air Lines,ORD,MKE
DL192,1692467037,1692468685,1648,19588,Delta Air Lines,MKE,SFO
DL192,1692490027,1692493339,3312,5395,Delta Air Lines,SFO,ORD
DL192,1692500190,1692501910,1720,20025,Delta Air Lines,ORD,MKE
DL192,1692529663,1692531511,1848,8819,Delta Air Lines,MKE,ORD
DL192,1692545008,1692546244,1236,6584,Delta Air Lines,ORD,MKE
DL192,1692555415,1692556679,1264,10724,Delta Air Lines,MKE,LAX
DL192,1692576185,1692586927,10742,12738,Delta Air Lines,LAX,ORD
DL192,1692608610,1692608661,51,10747,Delta Air Lines,ORD,MKE
DL192,1692625022,1692629440,4418,15115,Delta Air Lines,MKE,ORD
DL192,1692648701,1692650171,1470,21537,Delta Air Lines,ORD,MKE
DL192,1692680997,1692682771,1774,7562,Delta Air Lines,MKE,LAX
DL192,1692696131,1692697698,1567,14721,Delta Air Lines,LAX,SFO
DL192,1692722562,1692723416,854,16869,Delta Air Lines,SFO,LAX
DL192,1692745804,1692747314,1510,11618,Delta Air Lines,LAX,SFO
DL192,1692769655,1692770815,1160,21075,Delta Air Lines,SFO,LAX
DL192,1692794212,1692794254,42,8928,Delta Air Lines,LAX,SFO
DL192,1692810371,1692817113,6742,10961,Delta Air Lines,SFO,ORD
DL192,1692833709,1692834341,632,10037,Delta Air Lines,ORD,MKE
DL192,1692852371,1692854005,1634,11241,Delta Air Lines,MKE,LAX
DL192,1692868567,1692869143,576,16518,Delta Air Lines,LAX,SFO
DL192,1692892191,1692898430,6239,13711,Delta Air Lines,SFO,ORD
DL192,1692912246,1692912409,163,20124,Delta Air Lines,ORD,MKE
DL192,1692937039,1692938146,1107,21194,Delta Air Lines,MKE,SFO
DL192,1692962561,1692965344,2783,18655,Delta Air Lines,SFO,ORD
DL192,1692987244,1692988504,1260,10686,Delta Air Lines,ORD,MKE
DL192,1693001254,1693001386,132,19447,Delta Air Lines,MKE,LAX
DL192,1693023778,1693026307,2529,4533,Delta Air Lines,LAX,ORD
DL192,1693039553,1693040792,1239,8352,Delta Air Lines,ORD,MKE
DL192,1693056918,1693062437,5519,8843,Delta Air Lines,MKE,ORD
DL192,1693079308,1693079314,6,19187,Delta Air Lines,ORD,MKE
DL192,1693100310,1693101595,1285,11276,Delta Air Lines,MKE,LAX
DL192,1693123220,1693129534,6314,20146,Delta Air Lines,LAX,ORD
DL192,1693151076,1693151506,430,12899,Delta Air Lines,ORD,MKE
DL192,1693166141,1693173416,7275,7340,Delta Air Lines,MKE,ORD
DL192,1693189267,1693189977,710,9352,Delta Air Lines,ORD,MKE
DL192,1693201517,1693202186,669,8641,Delta Air Lines,MKE,SFO
DL192,1693213304,1693220407,7103,7922,Delta Air Lines,SFO,ORD
DL192,1693229895,1693230223,328,14240,Delta Air Lines,ORD,MKE
DL192,1693245079,1693251858,6779,3643,Delta Air Lines,MKE,ORD
DL192,1693259726,1693260684,958,6631,Delta Air Lines,ORD,MKE
DL192,1693275807,1693276426,619,15757,Delta Air Lines,MKE,LAX
DL192,1693293762,1693297550,3788,17060,Delta Air Lines,LAX,ORD
DL192,1693314681,1693316241,1560,12191,Delta Air Lines,ORD,MKE
DL192,1693331975,1693340189,8214,13846,Delta Air Lines,MKE,ORD
DL192,1693362957,1693364188,1231,10532,Delta Air Lines,ORD,MKE
DL192,1693376398,1693376972,574,19818,Delta Air Lines,MKE,LAX
DL192,1693407032,1693409762,2730,16408,Delta Air Lines,LAX,ORD
DL192,1693427720,1693429280,1560,3718,Delta Air Lines,ORD,MKE
DL192,1693435951,1693437459,1508,9058,Delta Air Lines,MKE,LAX
DL192,1693449826,1693450166,340,11779,Delta Air Lines,LAX,SFO
DL192,1693470320,1693471846,1526,11910,Delta Air Lines,SFO,LAX
DL192,1693483825,1693492342,8517,4257,Delta Air Lines,LAX,ORD
DL192,1693506424,1693507499,1075,18832,Delta Air Lines,ORD,MKE
DL192,1693536058,1693540300,4242,13068,Delta Air Lines,MKE,ORD
DL192,1693557212,1693557889,677,4646,Delta Air Lines,ORD,MKE
DL192,1693563219,1693568208,4989,9180,Delta Air Lines,MKE,ORD
DL192,1693583704,1693584330,626,10292,Delta Air Lines,ORD,MKE
DL192,1693597434,1693604769,7335,16211,Delta Air Lines,MKE,ORD
DL192,1693621291,1693622323,1032,10410,Delta Air Lines,ORD,MKE
DL192,1693636169,1693638524,2355,13034,Delta Air Lines,MKE,ORD
DL192,1693660476,1693660860,384,10963,Delta Air Lines,ORD,MKE
DL192,1693678065,1693681579,3514,18519,Delta Air Lines,MKE,ORD
DL192,1693708371,1693710100,1729,12509,Delta Air Lines,ORD,MKE
DL192,1693724214,1693724437,223,4010,Delta Air Lines,MKE,SFO
DL192,1693734610,1693739593,4983,19293,Delta Air Lines,SFO,ORD
DL192,1693760602,1693761042,440,5494,Delta Air Lines,ORD,MKE
DL192,1693769778,1693771311,1533,10975,Delta Air Lines,MKE,LAX
DL192,1693791615,1693796929,5314,15775,Delta Air Lines,LAX,ORD
DL192,1693813545,1693814039,494,11474,Delta Air Lines,ORD,MKE
DL192,1693831261,1693832475,1214,10095,Delta Air Lines,MKE,SFO
DL192,1693844481,1693854463,9982,14383,Delta Air Lines,SFO,ORD
DL192,1693872448,1693873156,708,17119,Delta Air Lines,ORD,MKE
DL192,1693899781,1693909655,9874,11407,Delta Air Lines,MKE,ORD
DL192,1693922499,1693923056,557,20334,Delta Air Lines,ORD,MKE
DL192,1693953053,1693953272,219,13081,Delta Air Lines,MKE,LAX
DL192,1693976602,1693987169,10567,20011,Delta Air Lines,LAX,ORD
DL192,1694013453,1694014613,1160,5226,Delta Air Lines,ORD,MKE
DL192,1694024544,1694025920,1376,4099,Delta Air Lines,MKE,SFO
DL192,1694033167,1694039612,6445,11941,Delta Air Lines,SFO,ORD
DL192,1694052723,1694053324,601,18128,Delta Air Lines,ORD,MKE
DL192,1694078343,1694078839,496,20498,Delta Air Lines,MKE,LAX
DL192,1694109135,1694109329,194,4708,Delta Air Lines,LAX,SFO
DL192,1694119108,1694120608,1500,12974,Delta Air Lines,SFO,LAX
DL192,1694141551,1694152223,10672,11554,Delta Air Lines,LAX,ORD
DL192,1694174180,1694175858,1678,20086,Delta Air Lines,ORD,MKE
DL192,1694202804,1694206776,3972,11467,Delta Air Lines,MKE,ORD
DL192,1694228360,1694229367,1007,20658,Delta Air Lines,ORD,MKE
DL192,1694251665,1694252456,791,10295,Delta Air Lines,MKE,LAX
DL192,1694265608,1694266857,1249,21088,Delta Air Lines,LAX,SFO
DL192,1694297043,1694304224,7181,20240,Delta Air Lines,SFO,ORD
DL192,1694329036,1694329672,636,6208,Delta Air Lines,ORD,MKE
DL192,1694343931,1694345051,1120,11579,Delta Air Lines,MKE,LAX
DL192,1694362224,1694369870,7646,17250,Delta Air Lines,LAX,ORD
DL192,1694392745,1694393584,839,5213,Delta Air Lines,ORD,MKE
DL192,1694405033,1694414581,9548,21312,Delta Air Lines,MKE,ORD
DL192,1694443072,1694443414,342,17281,Delta Air Lines,ORD,MKE
DL192,1694466763,1694467441,678,10691,Delta Air Lines,MKE,LAX
DL192,1694487241,1694488494,1253,13227,Delta Air Lines,LAX,SFO
DL192,1694509074,1694518021,8947,8116,Delta Air Lines,SFO,ORD
DL192,1694532975,1694533354,379,13636,Delta Air Lines,ORD,MKE
DL192,1694551604,1694553263,1659,5371,Delta Air Lines,MKE,SFO
DL192,1694567773,1694577088,9315,3660,Delta Air Lines,SFO,ORD
DL192,1694586127,1694587130,1003,5318,Delta Air Lines,ORD,MKE
DL192,1694602479,1694612579,10100,15624,Delta Air Lines,MKE,ORD
DL192,1694636690,1694637972,1282,7322,Delta Air Lines,ORD,MKE
DL192,1694649774,1694650410,636,9115,Delta Air Lines,MKE,LAX
DL192,1694664941,1694669786,4845,19644,Delta Air Lines,LAX,ORD
DL192,1694695815,1694696756,941,8103,Delta Air Lines,ORD,MKE
DL192,1694711999,1694719954,7955,11176,Delta Air Lines,MKE,ORD
DL192,1694738094,1694738835,741,3739,Delta Air Lines,ORD,MKE
DL192,1694742949,1694744096,1147,11326,Delta Air Lines,MKE,SFO
DL192,1694766118,1694766338,220,8843,Delta Air Lines,SFO,LAX
DL192,1694777803,1694778530,727,21384,Delta Air Lines,LAX,SFO
DL192,1694808552,1694817342,8790,18739,Delta Air Lines,SFO,ORD
DL192,1694838319,1694839806,1487,8480,Delta Air Lines,ORD,MKE
DL192,1694850408,1694851872,1464,5263,Delta Air Lines,MKE,LAX
DL192,1694864680,1694874795,10115,18870,Delta Air Lines,LAX,ORD
DL192,1694896611,1694898023,1412,8250,Delta Air Lines,ORD,MKE
DL192,1694911631,1694912785,1154,8202,Delta Air Lines,MKE,LAX
DL192,1694922497,1694930262,7765,10042,Delta Air Lines,LAX,ORD
DL192,1694945895,1694946953,1058,17892,Delta Air Lines,ORD,MKE
DL192,1694966508,1694966895,387,11986,Delta Air Lines,MKE,LAX
DL192,1694982273,1694990261,7988,18828,Delta Air Lines,LAX,ORD
DL192,1695011336,1695012084,748,14134,Delta Air Lines,ORD,MKE
DL192,1695035997,1695046626,10629,10045,Delta Air Lines,MKE,ORD
DL192,1695058143,1695058408,265,12996,Delta Air Lines,ORD,MKE
DL192,1695074603,1695075930,1327,12797,Delta Air Lines,MKE,SFO
DL192,1695097051,1695107575,10524,18261,Delta Air Lines,SFO,ORD
DL192,1695130917,1695132591,1674,12375,Delta Air Lines,ORD,MKE
DL192,1695145788,1695153070,7282,5854,Delta Air Lines,MKE,ORD
DL192,1695167179,1695167673,494,7420,Delta Air Lines,ORD,MKE
DL192,1695183345,1695186392,3047,14818,Delta Air Lines,MKE,ORD
DL192,1695206960,1695208673,1713,17192,Delta Air Lines,ORD,MKE
DL192,1695227087,1695236594,9507,11235,Delta Air Lines,MKE,ORD
DL192,1695257792,1695259566,1774,20781,Delta Air Lines,ORD,MKE
DL192,1695281727,1695285850,4123,7940,Delta Air Lines,MKE,ORD
DL192,1695295261,1695295857,596,5109,Delta Air Lines,ORD,MKE
DL192,1695309317,1695314192,4875,17349,Delta Air Lines,MKE,ORD
DL192,1695339677,1695340434,757,16501,Delta Air Lines,ORD,MKE
DL192,1695359639,1695359643,4,5347,Delta Air Lines,MKE,LAX
DL192,1695374476,1695378635,4159,8794,Delta Air Lines,LAX,ORD
DL192,1695389394,1695390259,865,16350,Delta Air Lines,ORD,MKE
DL192,1695416857,1695417011,154,5296,Delta Air Lines,MKE,LAX
DL192,1695431688,1695435138,3450,6539,Delta Air Lines,LAX,ORD
DL192,1695447942,1695449268,1326,8433,Delta Air Lines,ORD,MKE
DL192,1695465843,1695465951,108,6397,Delta Air Lines,MKE,SFO
DL192,1695481665,1695490237,8572,20510,Delta Air Lines,SFO,ORD
DL192,1695517282,1695517974,692,11784,Delta Air Lines,ORD,MKE
DL192,1695538970,1695538992,22,8390,Delta Air Lines,MKE,SFO
DL192,1695549218,1695557039,7821,10744,Delta Air Lines,SFO,ORD
DL192,1695571954,1695573534,1580,10833,Delta Air Lines,ORD,MKE
DL192,1695592352,1695592845,493,18296,Delta Air Lines,MKE,SFO
DL192,1695613654,1695619264,5610,14510,Delta Air Lines,SFO,ORD
DL192,1695638998,1695639087,89,20813,Delta Air Lines,ORD,MKE
DL192,1695662220,1695662328,108,13057,Delta Air Lines,MKE,LAX
DL192,1695682804,1695687236,4432,4447,Delta Air Lines,LAX,ORD
DL192,1695700592,1695701627,1035,21477,Delta Air Lines,ORD,MKE
DL192,1695724309,1695724413,104,11508,Delta Air Lines,MKE,SFO
DL192,1695739324,1695749369,10045,11247,Delta Air Lines,SFO,ORD
DL192,1695763386,1695764229,843,20103,Delta Air Lines,ORD,MKE
DL192,1695787183,1695789692,2509,20779,Delta Air Lines,MKE,ORD
DL192,1695817026,1695818742,1716,5739,Delta Air Lines,ORD,MKE
DL192,1695827030,1695828466,1436,19156,Delta Air Lines,MKE,SFO
DL192,1695853543,1695854956,1413,7846,Delta Air Lines,SFO,LAX
DL192,1695866842,1695869413,2571,12526,Delta Air Lines,LAX,ORD
DL192,1695882442,1695883507,1065,12699,Delta Air Lines,ORD,MKE
DL192,1695899802,1695900120,318,14896,Delta Air Lines,MKE,LAX
DL192,1695918655,1695919629,974,8989,Delta Air Lines,LAX,SFO
DL192,1695929960,1695931023,1063,17201,Delta Air Lines,SFO,LAX
DL192,1695957948,1695959201,1253,18635,Delta Air Lines,LAX,SFO
DL192,1695978268,1695979409,1141,9547,Delta Air Lines,SFO,LAX
DL192,1695996728,1696006448,9720,17245,Delta Air Lines,LAX,ORD
DL192,1696032242,1696032320,78,15721,Delta Air Lines,ORD,MKE
DL192,1696049378,1696050707,1329,9644,Delta Air Lines,MKE,LAX
DL192,1696062823,1696071717,8894,8492,Delta Air Lines,LAX,ORD
DL192,1696088809,1696090563,1754,10008,Delta Air Lines,ORD,MKE
DL192,1696101760,1696102147,387,19304,Delta Air Lines,MKE,SFO
DL192,1696128362,1696132483,4121,11884,Delta Air Lines,SFO,ORD
DL192,1696150035,1696150548,513,17300,Delta Air Lines,ORD,MKE
DL192,1696174494,1696175500,1006,12251,Delta Air Lines,MKE,SFO
DL192,1696196807,1696203971,7164,10009,Delta Air Lines,SFO,ORD
DL192,1696219588,1696219984,396,16813,Delta Air Lines,ORD,MKE
DL192,1696245105,1696245438,333,14601,Delta Air Lines,MKE,SFO
DL192,1696269618,1696270744,1126,9455,Delta Air Lines,SFO,LAX
DL192,1696280547,1696282785,2238,15968,Delta Air Lines,LAX,ORD
DL192,1696306741,1696308310,1569,17445,Delta Air Lines,ORD,MKE
DL192,1696328695,1696329271,576,10487,Delta Air Lines,MKE,LAX
DL192,1696346302,1696347331,1029,7713,Delta Air Lines,LAX,SFO
DL192,1696356225,1696356563,338,9321,Delta Air Lines,SFO,LAX
DL192,1696374437,1696374549,112,20456,Delta Air Lines,LAX,SFO
DL192,1696401686,1696403034,1348,10090,Delta Air Lines,SFO,LAX
DL192,1696414784,1696420937,6153,10665,Delta Air Lines,LAX,ORD
DL192,1696433413,1696434056,643,19917,Delta Air Lines,ORD,MKE
DL192,1696464706,1696466817,2111,10402,Delta Air Lines,MKE,ORD
DL192,1696479085,1696480809,1724,19743,Delta Air Lines,ORD,MKE
DL192,1696510868,1696511030,162,14717,Delta Air Lines,MKE,SFO
DL192,1696535769,1696540284,4515,15924,Delta Air Lines,SFO,ORD
DL192,1696556405,1696557370,965,9743,Delta Air Lines,ORD,MKE
DL192,1696575448,1696575533,85,13968,Delta Air Lines,MKE,LAX
DL192,1696593740,1696597709,3969,21480,Delta Air Lines,LAX,ORD
DL192,1696625300,1696625524,224,6557,Delta Air Lines,ORD,MKE
DL192,1696632412,1696633635,1223,13443,Delta Air Lines,MKE,SFO
DL192,1696656388,1696662481,6093,13597,Delta Air Lines,SFO,ORD
DL192,1696682213,1696683705,1492,6717,Delta Air Lines,ORD,MKE
DL192,1696699617,1696707253,7636,3741,Delta Air Lines,MKE,ORD
DL192,1696714530,1696715319,789,15700,Delta Air Lines,ORD,MKE
DL192,1696738894,1696747305,8411,20548,Delta Air Lines,MKE,ORD
DL192,1696771252,1696772789,1537,13632,Delta Air Lines,ORD,MKE
DL192,1696787540,1696788648,1108,14237,Delta Air Lines,MKE,SFO
DL192,1696806176,1696807470,1294,13839,Delta Air Lines,SFO,LAX
DL192,1696821477,1696829786,8309,20475,Delta Air Lines,LAX,ORD
DL192,1696858443,1696858616,173,20628,Delta Air Lines,ORD,MKE
DL192,1696883943,1696885204,1261,13240,Delta Air Lines,MKE,SFO
DL192,1696901029,1696910024,8995,11029,Delta Air Lines,SFO,ORD
DL192,1696928364,1696929605,1241,14101,Delta Air Lines,ORD,MKE
DL192,1696946926,1696955750,8824,13650,Delta Air Lines,MKE,ORD
DL192,1696972829,1696973072,243,17848,Delta Air Lines,ORD,MKE
DL192,1696994377,1696994731,354,9963,Delta Air Lines,MKE,LAX
DL192,1697011147,1697021473,10326,7699,Delta Air Lines,LAX,ORD
DL192,1697029625,1697029810,185,21297,Delta Air Lines,ORD,MKE
DL192,1697059238,1697060692,1454,11202,Delta Air Lines,MKE,SFO
DL192,1697082329,1697083120,791,14026,Delta Air Lines,SFO,LAX
DL192,1697099633,1697107737,8104,16708,Delta Air Lines,LAX,ORD
DL192,1697130647,1697131617,970,15043,Delta Air Lines,ORD,MKE
DL192,1697157300,1697158223,923,20145,Delta Air Lines,MKE,SFO
DL192,1697183928,1697184662,734,4496,Delta Air Lines,SFO,LAX
DL192,1697192166,1697198120,5954,9659,Delta Air Lines,LAX,ORD
DL192,1697213430,1697214944,1514,6208,Delta Air Lines,ORD,MKE
DL192,1697222827,1697223061,234,14535,Delta Air Lines,MKE,LAX
DL192,1697243457,1697254039,10582,11139,Delta Air Lines,LAX,ORD
DL192,1697275884,1697276027,143,6451,Delta Air Lines,ORD,MKE
DL192,1697290463,1697291934,1471,8393,Delta Air Lines,MKE,LAX
DL192,1697309569,1697319556,9987,18614,Delta Air Lines,LAX,ORD
DL192,1697344776,1697344820,44,4719,Delta Air Lines,ORD,MKE
DL192,1697357092,1697358261,1169,20178,Delta Air Lines,MKE,LAX
DL192,1697386583,1697387528,945,18453,Delta Air Lines,LAX,SFO
DL192,1697416161,1697416532,371,4147,Delta Air Lines,SFO,LAX
DL192,1697422347,1697423737,1390,11866,Delta Air Lines,LAX,SFO
DL192,1697444561,1697444790,229,11214,Delta Air Lines,SFO,LAX
DL192,1697456286,1697461647,5361,13659,Delta Air Lines,LAX,ORD
DL192,1697482560,1697483611,1051,11143,Delta Air Lines,ORD,MKE
DL192,1697503700,1697505096,1396,19308,Delta Air Lines,MKE,LAX
DL192,1697532249,1697533070,821,8459,Delta Air Lines,LAX,SFO
DL192,1697548582,1697548678,96,19695,Delta Air Lines,SFO,LAX
DL192,1697572016,1697573733,1717,6615,Delta Air Lines,LAX,SFO
DL192,1697586439,1697588165,1726,20654,Delta Air Lines,SFO,LAX
DL192,1697612617,1697613294,677,11572,Delta Air Lines,LAX,SFO
DL192,1697631459,1697639356,7897,11318,Delta Air Lines,SFO,ORD
DL192,1697660627,1697661067,440,14731,Delta Air Lines,ORD,MKE
DL192,1697676932,1697682796,5864,10836,Delta Air Lines,MKE,ORD
DL192,1697697042,1697697516,474,14120,Delta Air Lines,ORD,MKE
DL192,1697714337,1697723013,8676,7089,Delta Air Lines,MKE,ORD
DL192,1697738277,1697738511,234,18222,Delta Air Lines,ORD,MKE
DL192,1697760410,1697761945,1535,4776,Delta Air Lines,MKE,SFO
DL192,1697775904,1697781138,5234,9611,Delta Air Lines,SFO,ORD
DL192,1697795658,1697797212,1554,18036,Delta Air Lines,ORD,MKE
DL192,1697824556,1697832707,8151,8484,Delta Air Lines,MKE,ORD
DL192,1697845632,1697846548,916,18811,Delta Air Lines,ORD,MKE
DL192,1697866598,1697868430,1832,7027,Delta Air Lines,MKE,ORD
DL192,1697876375,1697877327,952,5593,Delta Air Lines,ORD,MKE
DL192,1697885010,1697894855,9845,4918,Delta Air Lines,MKE,ORD
DL192,1697901909,1697902772,863,15392,Delta Air Lines,ORD,MKE
DL192,1697921592,1697921706,114,9123,Delta Air Lines,MKE,SFO
DL192,1697941492,1697947502,6010,6376,Delta Air Lines,SFO,ORD
DL192,1697964284,1697964542,258,10703,Delta Air Lines,ORD,MKE
DL192,1697980827,1697982300,1473,8102,Delta Air Lines,MKE,LAX
DL192,1697995313,1698004970,9657,10020,Delta Air Lines,LAX,ORD
DL192,1698017336,1698018995,1659,6952,Delta Air Lines,ORD,MKE
DL192,1698029429,1698031199,1770,9669,Delta Air Lines,MKE,SFO
DL192,1698042401,1698044093,1692,19946,Delta Air Lines,SFO,LAX
DL192,1698074041,1698080254,6213,21001,Delta Air Lines,LAX,ORD
DL192,1698102169,1698102848,679,9890,Delta Air Lines,ORD,MKE
DL192,1698114018,1698115199,1181,14675,Delta Air Lines,MKE,LAX
DL192,1698137217,1698145869,8652,9083,Delta Air Lines,LAX,ORD
DL192,1698165255,1698165640,385,17961,Delta Air Lines,ORD,MKE
DL192,1698188626,1698190286,1660,9768,Delta Air Lines,MKE,SFO
DL192,1698204997,1698212530,7533,3857,Delta Air Lines,SFO,ORD
DL192,1698224286,1698224463,177,4624,Delta Air Lines,ORD,MKE
DL192,1698229388,1698229421,33,11999,Delta Air Lines,MKE,LAX
DL192,1698251635,1698252861,1226,9888,Delta Air Lines,LAX,SFO
DL192,1698272020,1698276298,4278,20837,Delta Air Lines,SFO,ORD
DL192,1698305710,1698306645,935,11265,Delta Air Lines,ORD,MKE
DL192,1698322301,1698323175,874,15966,Delta Air Lines,MKE,LAX
DL192,1698345227,1698346147,920,10667,Delta Air Lines,LAX,SFO
DL192,1698361684,1698368293,6609,6710,Delta Air Lines,SFO,ORD
DL192,1698380093,1698381615,1522,6507,Delta Air Lines,ORD,MKE
DL192,1698392812,1698401877,9065,5009,Delta Air Lines,MKE,ORD
DL192,1698408961,1698409739,778,5066,Delta Air Lines,ORD,MKE
DL192,1698419662,1698426206,6544,20818,Delta Air Lines,MKE,ORD
DL192,1698452496,1698453248,752,15436,Delta Air Lines,ORD,MKE
DL192,1698475690,1698477257,1567,11311,Delta Air Lines,MKE,SFO
DL192,1698490433,1698500435,10002,7275,Delta Air Lines,SFO,ORD
AA920,1682959659,1682966507,6848,15623,American Airlines,LAX,ORD
AA920,1682984639,1682984699,60,7645,American Airlines,ORD,MKE
AA920,1682994841,1682999744,4903,21361,American Airlines,MKE,ORD
AA920,1683024503,1683026216,1713,18403,American Airlines,ORD,MKE
AA920,1683053804,1683062090,8286,19146,American Airlines,MKE,ORD
AA920,1683090255,1683091183,928,18145,American Airlines,ORD,MKE
AA920,1683119439,1683120523,1084,6557,American Airlines,MKE,LAX
AA920,1683127612,1683129078,1466,4925,American Airlines,LAX,SFO
AA920,1683137235,1683140881,3646,6777,American Airlines,SFO,ORD
AA920,1683152183,1683153621,1438,8711,American Airlines,ORD,MKE
AA920,1683164956,1683166635,1679,14351,American Airlines,MKE,SFO
AA920,1683184891,1683192558,7667,9815,American Airlines,SFO,ORD
AA920,1683210910,1683212318,1408,4565,American Airlines,ORD,MKE
AA920,1683223606,1683233974,10368,5336,American Airlines,MKE,ORD
AA920,1683241797,1683242046,249,19037,American Airlines,ORD,MKE
AA920,1683268733,1683269010,277,15393,American Airlines,MKE,SFO
AA920,1683289248,1683289503,255,19751,American Airlines,SFO,LAX
AA920,1683310706,1683311361,655,15347,American Airlines,LAX,SFO
AA920,1683327351,1683334880,7529,18032,American Airlines,SFO,ORD
AA920,1683353650,1683354348,698,12643,American Airlines,ORD,MKE
AA920,1683375037,1683376991,1954,14637,American Airlines,MKE,ORD
AA920,1683393314,1683393434,120,6657,American Airlines,ORD,MKE
AA920,1683404420,1683405140,720,21520,American Airlines,MKE,LAX
AA920,1683427741,1683435574,7833,20338,American Airlines,LAX,ORD
AA920,1683459917,1683461042,1125,15309,American Airlines,ORD,MKE
AA920,1683481274,1683482783,1509,6445,American Airlines,MKE,LAX
AA920,1683489839,1683490197,358,11046,American Airlines,LAX,SFO
AA920,1683511418,1683515519,4101,11630,American Airlines,SFO,ORD
AA920,1683532375,1683533228,853,13976,American Airlines,ORD,MKE
AA920,1683555351,1683556010,659,6707,American Airlines,MKE,LAX
AA920,1683566483,1683568128,1645,12086,American Airlines,LAX,SFO
AA920,1683584156,1683585447,1291,17595,American Airlines,SFO,LAX
AA920,1683603795,1683613447,9652,19685,American Airlines,LAX,ORD
AA920,1683641236,1683642882,1646,20297,American Airlines,ORD,MKE
AA920,1683673184,1683674178,994,7786,American Airlines,MKE,SFO
AA920,1683689239,1683692554,3315,18594,American Airlines,SFO,ORD
AA920,1683720840,1683721267,427,10983,American Airlines,ORD,MKE
AA920,1683736909,1683738060,1151,17207,American Airlines,MKE,SFO
AA920,1683759156,1683760137,981,14547,American Airlines,SFO,LAX
AA920,1683785039,1683789977,4938,6099,American Airlines,LAX,ORD
AA920,1683806806,1683808432,1626,16591,American Airlines,ORD,MKE
AA920,1683835300,1683844777,9477,9870,American Airlines,MKE,ORD
AA920,1683856518,1683856607,89,8525,American Airlines,ORD,MKE
AA920,1683870751,1683879456,8705,6861,American Airlines,MKE,ORD
AA920,1683889839,1683889911,72,4866,American Airlines,ORD,MKE
AA920,1683895141,1683896873,1732,10494,American Airlines,MKE,SFO
AA920,1683908081,1683910609,2528,11720,American Airlines,SFO,ORD
AA920,1683930614,1683931379,765,7715,American Airlines,ORD,MKE
AA920,1683947468,1683952093,4625,5740,American Airlines,MKE,ORD
AA920,1683964804,1683966013,1209,6957,American Airlines,ORD,MKE
AA920,1683975344,1683976647,1303,12189,American Airlines,MKE,SFO
AA920,1683999082,1683999326,244,9679,American Airlines,SFO,LAX
AA920,1684016446,1684019151,2705,9148,American Airlines,LAX,ORD
AA920,1684030342,1684031596,1254,12010,American Airlines,ORD,MKE
AA920,1684051418,1684051917,499,3762,American Airlines,MKE,SFO
AA920,1684059236,1684061880,2644,4511,American Airlines,SFO,ORD
AA920,1684067153,1684067729,576,17063,American Airlines,ORD,MKE
AA920,1684088788,1684090423,1635,17158,American Airlines,MKE,LAX
AA920,1684118029,1684119273,1244,4229,American Airlines,LAX,SFO
AA920,1684129902,1684131616,1714,7176,American Airlines,SFO,LAX
AA920,1684139810,1684146269,6459,18069,American Airlines,LAX,ORD
AA920,1684170452,1684171790,1338,18726,American Airlines,ORD,MKE
AA920,1684197925,1684199018,1093,10365,American Airlines,MKE,SFO
AA920,1684212184,1684213838,1654,8595,American Airlines,SFO,LAX
AA920,1684231847,1684232320,473,16347,American Airlines,LAX,SFO
AA920,1684249274,1684249703,429,6032,American Airlines,SFO,LAX
AA920,1684261382,1684261704,322,11830,American Airlines,LAX,SFO
AA920,1684280024,1684284496,4472,8251,American Airlines,SFO,ORD
AA920,1684294247,1684295069,822,17857,American Airlines,ORD,MKE
AA920,1684321879,1684323041,1162,7588,American Airlines,MKE,LAX
AA920,1684330830,1684340640,9810,17922,American Airlines,LAX,ORD
AA920,1684367215,1684368377,1162,16180,American Airlines,ORD,MKE
AA920,1684388149,1684393165,5016,12023,American Airlines,MKE,ORD
AA920,1684407116,1684408116,1000,16474,American Airlines,ORD,MKE
AA920,1684427191,1684428128,937,17765,American Airlines,MKE,LAX
AA920,1684453963,1684454634,671,13350,American Airlines,LAX,SFO
AA920,1684475992,1684486332,10340,11694,American Airlines,SFO,ORD
AA920,1684502907,1684503187,280,4765,American Airlines,ORD,MKE
AA920,1684514168,1684522072,7904,12373,American Airlines,MKE,ORD
AA920,1684535368,1684536325,957,9357,American Airlines,ORD,MKE
AA920,1684555773,1684556354,581,15485,American Airlines,MKE,LAX
AA920,1684581074,1684590855,9781,8827,American Airlines,LAX,ORD
AA920,1684602562,1684604326,1764,21432,American Airlines,ORD,MKE
AA920,1684635017,1684645238,10221,8894,American Airlines,MKE,ORD
AA920,1684655736,1684655769,33,7964,American Airlines,ORD,MKE
AA920,1684670343,1684672014,1671,12164,American Airlines,MKE,LAX
AA920,1684684313,1684694998,10685,17447,American Airlines,LAX,ORD
AA920,1684720644,1684721179,535,17083,American Airlines,ORD,MKE
AA920,1684746961,1684752096,5135,7903,American Airlines,MKE,ORD
AA920,1684762842,1684764608,1766,20567,American Airlines,ORD,MKE
AA920,1684789343,1684790293,950,14943,American Airlines,MKE,SFO
AA920,1684815210,1684815289,79,5897,American Airlines,SFO,LAX
AA920,1684830934,1684831643,709,9287,American Airlines,LAX,SFO
AA920,1684847947,1684852871,4924,18020,American Airlines,SFO,ORD
AA920,1684870915,1684871409,494,4937,American Airlines,ORD,MKE
AA920,1684876654,1684877996,1342,21584,American Airlines,MKE,LAX
AA920,1684902875,1684904351,1476,19120,American Airlines,LAX,SFO
AA920,1684925907,1684935551,9644,8027,American Airlines,SFO,ORD
AA920,1684946707,1684947151,444,11450,American Airlines,ORD,MKE
AA920,1684966997,1684968748,1751,13417,American Airlines,MKE,LAX
AA920,1684990127,1684996609,6482,13485,American Airlines,LAX,ORD
AA920,1685011151,1685011586,435,16446,American Airlines,ORD,MKE
AA920,1685030147,1685030262,115,10451,American Airlines,MKE,SFO
AA920,1685047506,1685047929,423,13439,American Airlines,SFO,LAX
AA920,1685066079,1685066379,300,16253,American Airlines,LAX,SFO
AA920,1685089424,1685090444,1020,15790,American Airlines,SFO,LAX
AA920,1685116711,1685116777,66,7063,American Airlines,LAX,SFO
AA920,1685128935,1685134528,5593,8810,American Airlines,SFO,ORD
AA920,1685153017,1685153931,914,9432,American Airlines,ORD,MKE
AA920,1685173358,1685173904,546,11662,American Airlines,MKE,SFO
AA920,1685189350,1685189857,507,17987,American Airlines,SFO,LAX
AA920,1685210075,1685210807,732,16574,American Airlines,LAX,SFO
AA920,1685232276,1685240950,8674,7290,American Airlines,SFO,ORD
AA920,1685258695,1685260226,1531,11423,American Airlines,ORD,MKE
AA920,1685276805,1685277831,1026,11797,American Airlines,MKE,LAX
AA920,1685297172,1685298865,1693,14921,American Airlines,LAX,SFO
AA920,1685322647,1685328948,6301,6596,American Airlines,SFO,ORD
AA920,1685338768,1685338888,120,5079,American Airlines,ORD,MKE
AA920,1685346800,1685348117,1317,21242,American Airlines,MKE,SFO
AA920,1685379431,1685382183,2752,8883,American Airlines,SFO,ORD
AA920,1685399034,1685399707,673,18620,American Airlines,ORD,MKE
AA920,1685425396,1685426911,1515,7263,American Airlines,MKE,LAX
AA920,1685436827,1685443623,6796,4687,American Airlines,LAX,ORD
AA920,1685448441,1685449423,982,13680,American Airlines,ORD,MKE
AA920,1685464403,1685466061,1658,11442,American Airlines,MKE,SFO
AA920,1685483907,1685484193,286,4828,American Airlines,SFO,LAX
AA920,1685490083,1685491036,953,16860,American Airlines,LAX,SFO
AA920,1685514382,1685514845,463,16647,American Airlines,SFO,LAX
AA920,1685538944,1685543128,4184,8943,American Airlines,LAX,ORD
AA920,1685562219,1685562489,270,12518,American Airlines,ORD,MKE
AA920,1685576220,1685580460,4240,17439,American Airlines,MKE,ORD
AA920,1685601380,1685602108,728,13792,American Airlines,ORD,MKE
AA920,1685624176,1685624478,302,13579,American Airlines,MKE,SFO
AA920,1685640341,1685645694,5353,16925,American Airlines,SFO,ORD
AA920,1685670902,1685671351,449,20056,American Airlines,ORD,MKE
AA920,1685698730,1685698975,245,20477,American Airlines,MKE,SFO
AA920,1685727505,1685736066,8561,6034,American Airlines,SFO,ORD
AA920,1685749410,1685750448,1038,13279,American Airlines,ORD,MKE
AA920,1685772371,1685781423,9052,14567,American Airlines,MKE,ORD
AA920,1685797915,1685798831,916,11960,American Airlines,ORD,MKE
AA920,1685816970,1685817916,946,12137,American Airlines,MKE,LAX
AA920,1685840495,1685841019,524,13142,American Airlines,LAX,SFO
AA920,1685856369,1685856742,373,20612,American Airlines,SFO,LAX
AA920,1685882272,1685885350,3078,5158,American Airlines,LAX,ORD
AA920,1685895964,1685897738,1774,14979,American Airlines,ORD,MKE
AA920,1685919083,1685928923,9840,3722,American Airlines,MKE,ORD
AA920,1685936112,1685937297,1185,8142,American Airlines,ORD,MKE
AA920,1685953589,1685955068,1479,4306,American Airlines,MKE,LAX
AA920,1685964350,1685965807,1457,13783,American Airlines,LAX,SFO
AA920,1685990188,1685998395,8207,7420,American Airlines,SFO,ORD
AA920,1686016176,1686017488,1312,8539,American Airlines,ORD,MKE
AA920,1686028834,1686029636,802,17316,American Airlines,MKE,SFO
AA920,1686048932,1686057649,8717,6440,American Airlines,SFO,ORD
AA920,1686069059,1686070229,1170,10020,American Airlines,ORD,MKE
AA920,1686088890,1686089498,608,6461,American Airlines,MKE,SFO
AA920,1686103524,1686111212,7688,4408,American Airlines,SFO,ORD
AA920,1686117228,1686118944,1716,16854,American Airlines,ORD,MKE
AA920,1686136150,1686139058,2908,12232,American Airlines,MKE,ORD
AA920,1686152387,1686153742,1355,18485,American Airlines,ORD,MKE
AA920,1686173830,1686174650,820,16687,American Airlines,MKE,LAX
AA920,1686198048,1686199892,1844,13937,American Airlines,LAX,ORD
AA920,1686217803,1686219224,1421,21087,American Airlines,ORD,MKE
AA920,1686248731,1686249515,784,5345,American Airlines,MKE,LAX
AA920,1686259636,1686265095,5459,4237,American Airlines,LAX,ORD
AA920,1686271247,1686271397,150,13272,American Airlines,ORD,MKE
AA920,1686293909,1686294671,762,21430,American Airlines,MKE,LAX
AA920,1686320213,1686323772,3559,12765,American Airlines,LAX,ORD
AA920,1686339753,1686340159,406,17174,American Airlines,ORD,MKE
AA920,1686363385,1686364555,1170,18566,American Airlines,MKE,LAX
AA920,1686385056,1686385301,245,7483,American Airlines,LAX,SFO
AA920,1686398044,1686399657,1613,19222,American Airlines,SFO,LAX
AA920,1686429588,1686429718,130,6680,American Airlines,LAX,SFO
AA920,1686442339,1686442991,652,18475,American Airlines,SFO,LAX
AA920,1686471204,1686477287,6083,17620,American Airlines,LAX,ORD
AA920,1686502357,1686502906,549,15413,American Airlines,ORD,MKE
AA920,1686524586,1686525365,779,10053,American Airlines,MKE,LAX
AA920,1686543664,1686544761,1097,19154,American Airlines,LAX,SFO
AA920,1686568177,1686568445,268,5557,American Airlines,SFO,LAX
AA920,1686582961,1686584987,2026,14730,American Airlines,LAX,ORD
AA920,1686602128,1686602245,117,18151,American Airlines,ORD,MKE
AA920,1686625658,1686627295,1637,12405,American Airlines,MKE,SFO
AA920,1686649330,1686649963,633,6409,American Airlines,SFO,LAX
AA920,1686661710,1686666623,4913,17389,American Airlines,LAX,ORD
AA920,1686693677,1686695064,1387,9684,American Airlines,ORD,MKE
AA920,1686714666,1686714875,209,19234,American Airlines,MKE,SFO
AA920,1686735431,1686737177,1746,12261,American Airlines,SFO,LAX
AA920,1686756144,1686757852,1708,12837,American Airlines,LAX,SFO
AA920,1686777897,1686778247,350,3901,American Airlines,SFO,LAX
AA920,1686790884,1686791620,736,6822,American Airlines,LAX,SFO
AA920,1686809000,1686819306,10306,18228,American Airlines,SFO,ORD
AA920,1686843856,1686844452,596,11098,American Airlines,ORD,MKE
AA920,1686858496,1686859673,1177,9831,American Airlines,MKE,SFO
AA920,1686871122,1686871529,407,17075,American Airlines,SFO,LAX
AA920,1686892237,1686900793,8556,9544,American Airlines,LAX,ORD
AA920,1686914954,1686916319,1365,10233,American Airlines,ORD,MKE
AA920,1686926683,1686928401,1718,16212,American Airlines,MKE,SFO
AA920,1686955201,1686962468,7267,4837,American Airlines,SFO,ORD
AA920,1686971234,1686972101,867,11976,American Airlines,ORD,MKE
AA920,1686988171,1686993635,5464,10020,American Airlines,MKE,ORD
AA920,1687005006,1687006531,1525,18696,American Airlines,ORD,MKE
AA920,1687028057,1687029240,1183,10237,American Airlines,MKE,LAX
AA920,1687044622,1687045759,1137,3919,American Airlines,LAX,SFO
AA920,1687057764,1687061158,3394,16316,American Airlines,SFO,ORD
AA920,1687081901,1687082666,765,5416,American Airlines,ORD,MKE
AA920,1687095884,1687102404,6520,19461,American Airlines,MKE,ORD
AA920,1687125943,1687127239,1296,4356,American Airlines,ORD,MKE
AA920,1687132838,1687134310,1472,7916,American Airlines,MKE,LAX
AA920,1687146037,1687146150,113,6180,American Airlines,LAX,SFO
AA920,1687155463,1687155901,438,20529,American Airlines,SFO,LAX
AA920,1687177382,1687182843,5461,16251,American Airlines,LAX,ORD
AA920,1687209039,1687210214,1175,20414,American Airlines,ORD,MKE
AA920,1687234038,1687235266,1228,21116,American Airlines,MKE,LAX
AA920,1687260274,1687269228,8954,7387,American Airlines,LAX,ORD
AA920,1687284659,1687284776,117,17379,American Airlines,ORD,MKE
AA920,1687302362,1687303044,682,9565,American Airlines,MKE,LAX
AA920,1687322984,1687330879,7895,20339,American Airlines,LAX,ORD
AA920,1687358510,1687359022,512,6920,American Airlines,ORD,MKE
AA920,1687367159,1687369682,2523,15386,American Airlines,MKE,ORD
AA920,1687394511,1687394605,94,5361,American Airlines,ORD,MKE
AA920,1687402546,1687407360,4814,19625,American Airlines,MKE,ORD
AA920,1687436101,1687437636,1535,9976,American Airlines,ORD,MKE
AA920,1687449816,1687451784,1968,19989,American Airlines,MKE,ORD
AA920,1687472061,1687472175,114,6931,American Airlines,ORD,MKE
AA920,1687488111,1687488297,186,11681,American Airlines,MKE,SFO
AA920,1687502512,1687510262,7750,21055,American Airlines,SFO,ORD
AA920,1687538988,1687540467,1479,16510,American Airlines,ORD,MKE
AA920,1687563547,1687564814,1267,11457,American Airlines,MKE,LAX
AA920,1687579302,1687580586,1284,12089,American Airlines,LAX,SFO
AA920,1687600100,1687605983,5883,9556,American Airlines,SFO,ORD
AA920,1687622832,1687624253,1421,4398,American Airlines,ORD,MKE
AA920,1687637737,1687645079,7342,16082,American Airlines,MKE,ORD
AA920,1687665306,1687665352,46,21112,American Airlines,ORD,MKE
AA920,1687696261,1687697566,1305,18274,American Airlines,MKE,LAX
AA920,1687723805,1687724847,1042,11557,American Airlines,LAX,SFO
AA920,1687744925,1687745127,202,20894,American Airlines,SFO,LAX
AA920,1687769418,1687770679,1261,18232,American Airlines,LAX,SFO
AA920,1687791760,1687800107,8347,14918,American Airlines,SFO,ORD
AA920,1687823086,1687823426,340,19386,American Airlines,ORD,MKE
AA920,1687852146,1687853536,1390,9677,American Airlines,MKE,SFO
AA920,1687865770,1687867565,1795,13167,American Airlines,SFO,LAX
AA920,1687887565,1687891552,3987,8962,American Airlines,LAX,ORD
AA920,1687908845,1687910133,1288,16301,American Airlines,ORD,MKE
AA920,1687934685,1687935438,753,19749,American Airlines,MKE,SFO
AA920,1687957534,1687958150,616,8661,American Airlines,SFO,LAX
AA920,1687971155,1687977665,6510,10913,American Airlines,LAX,ORD
AA920,1687990480,1687991668,1188,8314,American Airlines,ORD,MKE
AA920,1688000595,1688010712,10117,20253,American Airlines,MKE,ORD
AA920,1688036914,1688037722,808,9972,American Airlines,ORD,MKE
AA920,1688051029,1688056089,5060,5308,American Airlines,MKE,ORD
AA920,1688069965,1688071125,1160,12642,American Airlines,ORD,MKE
AA920,1688088738,1688090112,1374,9668,American Airlines,MKE,LAX
AA920,1688109222,1688109574,352,9018,American Airlines,LAX,SFO
AA920,1688122472,1688124058,1586,17176,American Airlines,SFO,LAX
AA920,1688144957,1688146016,1059,21233,American Airlines,LAX,SFO
AA920,1688177196,1688180573,3377,19260,American Airlines,SFO,ORD
AA920,1688207835,1688209523,1688,7858,American Airlines,ORD,MKE
AA920,1688221354,1688222525,1171,21440,American Airlines,MKE,LAX
AA920,1688252282,1688257735,5453,19364,American Airlines,LAX,ORD
AA920,1688286924,1688287837,913,17788,American Airlines,ORD,MKE
AA920,1688306917,1688308372,1455,18437,American Airlines,MKE,SFO
AA920,1688335549,1688336443,894,5941,American Airlines,SFO,LAX
AA920,1688351335,1688353082,1747,7348,American Airlines,LAX,SFO
AA920,1688365174,1688371556,6382,8518,American Airlines,SFO,ORD
AA920,1688384482,1688385336,854,16322,American Airlines,ORD,MKE
AA920,1688403375,1688404608,1233,6284,American Airlines,MKE,LAX
AA920,1688412615,1688412878,263,20397,American Airlines,LAX,SFO
AA920,1688439174,1688448261,9087,6085,American Airlines,SFO,ORD
AA920,1688459891,1688460443,552,7596,American Airlines,ORD,MKE
AA920,1688469177,1688478107,8930,3826,American Airlines,MKE,ORD
AA920,1688491090,1688492445,1355,14136,American Airlines,ORD,MKE
AA920,1688513777,1688515107,1330,6342,American Airlines,MKE,LAX
AA920,1688525833,1688526521,688,12967,American Airlines,LAX,SFO
AA920,1688548096,1688549421,1325,16551,American Airlines,SFO,LAX
AA920,1688575343,1688583943,8600,10119,American Airlines,LAX,ORD
AA920,1688596664,1688597061,397,19719,American Airlines,ORD,MKE
AA920,1688627281,1688627593,312,16972,American Airlines,MKE,SFO
AA920,1688650367,1688658566,8199,16621,American Airlines,SFO,ORD
AA920,1688684530,1688685032,502,16363,American Airlines,ORD,MKE
AA920,1688708422,1688709092,670,10803,American Airlines,MKE,SFO
AA920,1688724423,1688724763,340,16369,American Airlines,SFO,LAX
AA920,1688749518,1688752338,2820,12692,American Airlines,LAX,ORD
AA920,1688773782,1688774092,310,20960,American Airlines,ORD,MKE
AA920,1688797781,1688803667,5886,10621,American Airlines,MKE,ORD
AA920,1688814820,1688816509,1689,14436,American Airlines,ORD,MKE
AA920,1688839560,1688849957,10397,18004,American Airlines,MKE,ORD
AA920,1688871347,1688872747,1400,16495,American Airlines,ORD,MKE
AA920,1688899741,1688899834,93,14928,American Airlines,MKE,LAX
AA920,1688921249,1688924688,3439,18603,American Airlines,LAX,ORD
AA920,1688949334,1688949880,546,18509,American Airlines,ORD,MKE
AA920,1688977367,1688978812,1445,17503,American Airlines,MKE,LAX
AA920,1689003518,1689003629,111,10356,American Airlines,LAX,SFO
AA920,1689016903,1689019197,2294,5735,American Airlines,SFO,ORD
AA920,1689025806,1689026410,604,15337,American Airlines,ORD,MKE
AA920,1689052339,1689054018,1679,5725,American Airlines,MKE,SFO
AA920,1689066200,1689066426,226,17070,American Airlines,SFO,LAX
AA920,1689086609,1689089462,2853,19791,American Airlines,LAX,ORD
AA920,1689116391,1689116794,403,8763,American Airlines,ORD,MKE
AA920,1689132175,1689137509,5334,7579,American Airlines,MKE,ORD
AA920,1689151044,1689152763,1719,16131,American Airlines,ORD,MKE
AA920,1689172217,1689173440,1223,11204,American Airlines,MKE,LAX
AA920,1689192360,1689199494,7134,5940,American Airlines,LAX,ORD
AA920,1689213058,1689213410,352,9214,American Airlines,ORD,MKE
AA920,1689223300,1689225288,1988,5957,American Airlines,MKE,ORD
AA920,1689232846,1689233391,545,7336,American Airlines,ORD,MKE
AA920,1689247087,1689252615,5528,6076,American Airlines,MKE,ORD
AA920,1689269268,1689270536,1268,18964,American Airlines,ORD,MKE
AA920,1689292635,1689296442,3807,20933,American Airlines,MKE,ORD
AA920,1689325300,1689325457,157,15817,American Airlines,ORD,MKE
AA920,1689350511,1689350940,429,14615,American Airlines,MKE,SFO
AA920,1689367180,1689369890,2710,14643,American Airlines,SFO,ORD
AA920,1689385695,1689386479,784,15712,American Airlines,ORD,MKE
AA920,1689412534,1689413102,568,13624,American Airlines,MKE,LAX
AA920,1689431589,1689433346,1757,10827,American Airlines,LAX,SFO
AA920,1689449867,1689450713,846,16331,American Airlines,SFO,LAX
AA920,1689471723,1689475340,3617,6406,American Airlines,LAX,ORD
AA920,1689491095,1689492422,1327,3802,American Airlines,ORD,MKE
AA920,1689501868,1689502730,862,14899,American Airlines,MKE,SFO
AA920,1689518836,1689524243,5407,6282,American Airlines,SFO,ORD
AA920,1689533455,1689534994,1539,12792,American Airlines,ORD,MKE
AA920,1689554170,1689555840,1670,16320,American Airlines,MKE,LAX
AA920,1689574458,1689578653,4195,9145,American Airlines,LAX,ORD
AA920,1689590849,1689591002,153,11468,American Airlines,ORD,MKE
AA920,1689607974,1689609213,1239,19832,American Airlines,MKE,LAX
AA920,1689638311,1689639003,692,6610,American Airlines,LAX,SFO
AA920,1689647187,1689647913,726,16721,American Airlines,SFO,LAX
AA920,1689672748,1689680244,7496,14873,American Airlines,LAX,ORD
AA920,1689700161,1689700875,714,15436,American Airlines,ORD,MKE
AA920,1689723217,1689723260,43,17521,American Airlines,MKE,LAX
AA920,1689747040,1689756727,9687,13910,American Airlines,LAX,ORD
AA920,1689780805,1689781094,289,14850,American Airlines,ORD,MKE
AA920,1689804562,1689814424,9862,8346,American Airlines,MKE,ORD
AA920,1689825682,1689827296,1614,6411,American Airlines,ORD,MKE
AA920,1689841131,1689848847,7716,17705,American Airlines,MKE,ORD
AA920,1689870258,1689871786,1528,8895,American Airlines,ORD,MKE
AA920,1689881629,1689886560,4931,19732,American Airlines,MKE,ORD
AA920,1689906424,1689907987,1563,14035,American Airlines,ORD,MKE
AA920,1689930240,1689931840,1600,14276,American Airlines,MKE,SFO
AA920,1689955530,1689956596,1066,11193,American Airlines,SFO,LAX
AA920,1689972918,1689973719,801,6752,American Airlines,LAX,SFO
AA920,1689988570,1689991657,3087,8043,American Airlines,SFO,ORD
AA920,1690010222,1690011328,1106,13090,American Airlines,ORD,MKE
AA920,1690035105,1690037252,2147,14535,American Airlines,MKE,ORD
AA920,1690057941,1690058152,211,17515,American Airlines,ORD,MKE
AA920,1690077933,1690078436,503,10418,American Airlines,MKE,SFO
AA920,1690093879,1690103012,9133,9141,American Airlines,SFO,ORD
AA920,1690121449,1690122750,1301,11457,American Airlines,ORD,MKE
AA920,1690138579,1690146652,8073,6665,American Airlines,MKE,ORD
AA920,1690162699,1690164250,1551,7235,American Airlines,ORD,MKE
AA920,1690177830,1690187849,10019,5338,American Airlines,MKE,ORD
AA920,1690195258,1690196824,1566,12060,American Airlines,ORD,MKE
AA920,1690212495,1690212581,86,21243,American Airlines,MKE,SFO
AA920,1690234331,1690239968,5637,5457,American Airlines,SFO,ORD
AA920,1690250438,1690251100,662,8372,American Airlines,ORD,MKE
AA920,1690260762,1690261112,350,11700,American Airlines,MKE,LAX
AA920,1690278250,1690285469,7219,13262,American Airlines,LAX,ORD
AA920,1690303919,1690305352,1433,7098,American Airlines,ORD,MKE
AA920,1690322469,1690323428,959,5956,American Airlines,MKE,LAX
AA920,1690336071,1690341485,5414,14715,American Airlines,LAX,ORD
AA920,1690358560,1690359726,1166,11297,American Airlines,ORD,MKE
AA920,1690372712,1690374302,1590,10242,American Airlines,MKE,LAX
AA920,1690392388,1690395295,2907,6550,American Airlines,LAX,ORD
AA920,1690405759,1690407426,1667,9556,American Airlines,ORD,MKE
AA920,1690417564,1690417648,84,13961,American Airlines,MKE,SFO
AA920,1690440999,1690441014,15,12928,American Airlines,SFO,LAX
AA920,1690459029,1690469104,10075,19598,American Airlines,LAX,ORD
AA920,1690490624,1690492130,1506,12432,American Airlines,ORD,MKE
AA920,1690507683,1690508710,1027,17449,American Airlines,MKE,LAX
AA920,1690536702,1690538260,1558,13896,American Airlines,LAX,SFO
AA920,1690554415,1690555937,1522,6796,American Airlines,SFO,LAX
AA920,1690572626,1690574069,1443,10219,American Airlines,LAX,SFO
AA920,1690589626,1690598855,9229,10631,American Airlines,SFO,ORD
AA920,1690611132,1690612674,1542,21032,American Airlines,ORD,MKE
AA920,1690639234,1690639493,259,6295,American Airlines,MKE,SFO
AA920,1690649217,1690649488,271,4870,American Airlines,SFO,LAX
AA920,1690662600,1690663305,705,5732,American Airlines,LAX,SFO
AA920,1690672145,1690673886,1741,6395,American Airlines,SFO,LAX
AA920,1690690524,1690698340,7816,4086,American Airlines,LAX,ORD
AA920,1690706683,1690707147,464,18227,American Airlines,ORD,MKE
AA920,1690729732,1690731091,1359,15659,American Airlines,MKE,LAX
AA920,1690752843,1690753564,721,7805,American Airlines,LAX,SFO
AA920,1690765669,1690771598,5929,9037,American Airlines,SFO,ORD
AA920,1690784531,1690786289,1758,6379,American Airlines,ORD,MKE
AA920,1690802657,1690809937,7280,4422,American Airlines,MKE,ORD
AA920,1690824365,1690825552,1187,20496,American Airlines,ORD,MKE
AA920,1690853178,1690853646,468,20634,American Airlines,MKE,LAX
AA920,1690874752,1690875822,1070,8100,American Airlines,LAX,SFO
AA920,1690892881,1690894141,1260,17598,American Airlines,SFO,LAX
AA920,1690914800,1690915956,1156,18793,American Airlines,LAX,SFO
AA920,1690938377,1690938729,352,6482,American Airlines,SFO,LAX
AA920,1690951471,1690951542,71,10576,American Airlines,LAX,SFO
AA920,1690968176,1690976362,8186,19887,American Airlines,SFO,ORD
AA920,1690996467,1690996576,109,18082,American Airlines,ORD,MKE
AA920,1691024115,1691025278,1163,5589,American Airlines,MKE,SFO
AA920,1691034525,1691035958,1433,14949,American Airlines,SFO,LAX
AA920,1691055364,1691057248,1884,6878,American Airlines,LAX,ORD
AA920,1691066158,1691066261,103,12813,American Airlines,ORD,MKE
AA920,1691089489,1691090468,979,9340,American Airlines,MKE,LAX
AA920,1691102380,1691104328,1948,13281,American Airlines,LAX,ORD
AA920,1691123209,1691124232,1023,15591,American Airlines,ORD,MKE
AA920,1691141692,1691146578,4886,19339,American Airlines,MKE,ORD
AA920,1691170854,1691172235,1381,18899,American Airlines,ORD,MKE
AA920,1691194159,1691194344,185,9817,American Airlines,MKE,LAX
AA920,1691212480,1691213584,1104,5490,American Airlines,LAX,SFO
AA920,1691226777,1691228204,1427,16459,American Airlines,SFO,LAX
AA920,1691253128,1691259184,6056,17329,American Airlines,LAX,ORD
AA920,1691281396,1691282990,1594,13391,American Airlines,ORD,MKE
AA920,1691299017,1691304420,5403,21223,American Airlines,MKE,ORD
AA920,1691328925,1691329129,204,21427,American Airlines,ORD,MKE
AA920,1691352969,1691354491,1522,15262,American Airlines,MKE,LAX
AA920,1691380399,1691385106,4707,6353,American Airlines,LAX,ORD
AA920,1691398717,1691399684,967,16400,American Airlines,ORD,MKE
AA920,1691420998,1691422540,1542,17720,American Airlines,MKE,LAX
AA920,1691445695,1691449239,3544,4647,American Airlines,LAX,ORD
AA920,1691463624,1691464780,1156,12351,American Airlines,ORD,MKE
AA920,1691477896,1691485411,7515,13722,American Airlines,MKE,ORD
AA920,1691508408,1691508808,400,14583,American Airlines,ORD,MKE
AA920,1691526141,1691527791,1650,16600,American Airlines,MKE,SFO
AA920,1691547092,1691548062,970,21269,American Airlines,SFO,LAX
AA920,1691572266,1691579247,6981,21332,American Airlines,LAX,ORD
AA920,1691605412,1691606420,1008,8873,American Airlines,ORD,MKE
AA920,1691618394,1691619787,1393,3981,American Airlines,MKE,LAX
AA920,1691630863,1691633862,2999,6076,American Airlines,LAX,ORD
AA920,1691645825,1691645865,40,5778,American Airlines,ORD,MKE
AA920,1691661831,1691662550,719,10401,American Airlines,MKE,SFO
AA920,1691682193,1691683627,1434,13288,American Airlines,SFO,LAX
AA920,1691702445,1691709497,7052,13825,American Airlines,LAX,ORD
AA920,1691732951,1691734297,1346,8498,American Airlines,ORD,MKE
AA920,1691744418,1691745788,1370,17665,American Airlines,MKE,LAX
AA920,1691769504,1691776104,6600,20726,American Airlines,LAX,ORD
AA920,1691802706,1691804159,1453,19049,American Airlines,ORD,MKE
AA920,1691833145,1691834859,1714,5597,American Airlines,MKE,LAX
AA920,1691848378,1691849965,1587,16639,American Airlines,LAX,SFO
AA920,1691869127,1691875437,6310,4309,American Airlines,SFO,ORD
AA920,1691889473,1691890050,577,10474,American Airlines,ORD,MKE
AA920,1691906898,1691915920,9022,17533,American Airlines,MKE,ORD
AA920,1691941381,1691941884,503,11801,American Airlines,ORD,MKE
AA920,1691961115,1691961257,142,5287,American Airlines,MKE,SFO
AA920,1691967228,1691971614,4386,7447,American Airlines,SFO,ORD
AA920,1691986495,1691986932,437,13041,American Airlines,ORD,MKE
AA920,1692003640,1692005127,1487,11904,American Airlines,MKE,SFO
AA920,1692026581,1692032605,6024,18852,American Airlines,SFO,ORD
AA920,1692053031,1692054377,1346,3719,American Airlines,ORD,MKE
AA920,1692064167,1692073059,8892,6125,American Airlines,MKE,ORD
AA920,1692084461,1692085864,1403,5214,American Airlines,ORD,MKE
AA920,1692094686,1692096392,1706,21196,American Airlines,MKE,SFO
AA920,1692122674,1692129375,6701,12327,American Airlines,SFO,ORD
AA920,1692147835,1692149634,1799,20573,American Airlines,ORD,MKE
AA920,1692178987,1692179135,148,3891,American Airlines,MKE,SFO
AA920,1692185053,1692186734,1681,11181,American Airlines,SFO,LAX
AA920,1692198862,1692207860,8998,18954,American Airlines,LAX,ORD
AA920,1692234718,1692234875,157,18850,American Airlines,ORD,MKE
AA920,1692263674,1692264150,476,19479,American Airlines,MKE,LAX
AA920,1692292237,1692293306,1069,10757,American Airlines,LAX,SFO
AA920,1692312229,1692313845,1616,18262,American Airlines,SFO,LAX
AA920,1692342198,1692348367,6169,3797,American Airlines,LAX,ORD
AA920,1692354325,1692355518,1193,17957,American Airlines,ORD,MKE
AA920,1692376944,1692378107,1163,18472,American Airlines,MKE,SFO
AA920,1692400428,1692401944,1516,11418,American Airlines,SFO,LAX
AA920,1692413849,1692418527,4678,8942,American Airlines,LAX,ORD
AA920,1692436328,1692436615,287,12570,American Airlines,ORD,MKE
AA920,1692457410,1692464930,7520,4432,American Airlines,MKE,ORD
AA920,1692476216,1692476843,627,7634,American Airlines,ORD,MKE
AA920,1692486200,1692489531,3331,9648,American Airlines,MKE,ORD
AA920,1692504301,1692504440,139,19345,American Airlines,ORD,MKE
AA920,1692526809,1692527249,440,20022,American Airlines,MKE,LAX
AA920,1692548107,1692552055,3948,15866,American Airlines,LAX,ORD
AA920,1692574047,1692575208,1161,10790,American Airlines,ORD,MKE
AA920,1692590701,1692592222,1521,16527,American Airlines,MKE,LAX
AA920,1692609140,1692615597,6457,11197,American Airlines,LAX,ORD
AA920,1692631172,1692631300,128,19693,American Airlines,ORD,MKE
AA920,1692652708,1692657560,4852,14165,American Airlines,MKE,ORD
AA920,1692676186,1692676755,569,3953,American Airlines,ORD,MKE
AA920,1692687280,1692688926,1646,7337,American Airlines,MKE,LAX
AA920,1692705993,1692706376,383,19714,American Airlines,LAX,SFO
AA920,1692733737,1692741204,7467,15362,American Airlines,SFO,ORD
AA920,1692757333,1692759084,1751,3925,American Airlines,ORD,MKE
AA920,1692765236,1692766255,1019,9744,American Airlines,MKE,LAX
AA920,1692781655,1692785051,3396,17168,American Airlines,LAX,ORD
AA920,1692807702,1692808122,420,18352,American Airlines,ORD,MKE
AA920,1692828860,1692829726,866,9389,American Airlines,MKE,LAX
AA920,1692840812,1692841433,621,5747,American Airlines,LAX,SFO
AA920,1692852626,1692860444,7818,4413,American Airlines,SFO,ORD
AA920,1692874017,1692874719,702,8100,American Airlines,ORD,MKE
AA920,1692883318,1692884838,1520,13601,American Airlines,MKE,SFO
AA920,1692899256,1692900689,1433,20009,American Airlines,SFO,LAX
AA920,1692928137,1692935042,6905,13470,American Airlines,LAX,ORD
AA920,1692951906,1692953694,1788,17530,American Airlines,ORD,MKE
AA920,1692975706,1692980711,5005,8360,American Airlines,MKE,ORD
AA920,1692992692,1692993855,1163,12838,American Airlines,ORD,MKE
AA920,1693014139,1693024576,10437,19144,American Airlines,MKE,ORD
AA920,1693049260,1693050242,982,15589,American Airlines,ORD,MKE
AA920,1693072279,1693072865,586,16087,American Airlines,MKE,SFO
AA920,1693094186,1693102032,7846,20994,American Airlines,SFO,ORD
AA920,1693131408,1693132210,802,5576,American Airlines,ORD,MKE
AA920,1693145384,1693146658,1274,11512,American Airlines,MKE,LAX
AA920,1693164493,1693164891,398,13452,American Airlines,LAX,SFO
AA920,1693179762,1693180245,483,12442,American Airlines,SFO,LAX
AA920,1693195453,1693196102,649,10424,American Airlines,LAX,SFO
AA920,1693216296,1693223854,7558,20851,American Airlines,SFO,ORD
AA920,1693252971,1693254672,1701,13478,American Airlines,ORD,MKE
AA920,1693270628,1693272340,1712,4936,American Airlines,MKE,SFO
AA920,1693285930,1693296306,10376,8187,American Airlines,SFO,ORD
AA920,1693312095,1693312785,690,5527,American Airlines,ORD,MKE
AA920,1693322818,1693324264,1446,5820,American Airlines,MKE,SFO
AA920,1693340548,1693341530,982,8139,American Airlines,SFO,LAX
AA920,1693355599,1693356641,1042,15732,American Airlines,LAX,SFO
AA920,1693381215,1693389475,8260,14411,American Airlines,SFO,ORD
AA920,1693411392,1693413146,1754,6032,American Airlines,ORD,MKE
AA920,1693422111,1693423725,1614,7716,American Airlines,MKE,SFO
AA920,1693435366,1693440759,5393,5477,American Airlines,SFO,ORD
AA920,1693451362,1693453131,1769,14695,American Airlines,ORD,MKE
AA920,1693477430,1693480050,2620,12991,American Airlines,MKE,ORD
AA920,1693499657,1693500578,921,20963,American Airlines,ORD,MKE
AA920,1693531108,1693532039,931,12713,American Airlines,MKE,LAX
AA920,1693552625,1693560123,7498,7339,American Airlines,LAX,ORD
AA920,1693569632,1693571137,1505,8974,American Airlines,ORD,MKE
AA920,1693586240,1693586803,563,16662,American Airlines,MKE,LAX
AA920,1693613002,1693621038,8036,11830,American Airlines,LAX,ORD
AA920,1693642277,1693642785,508,8955,American Airlines,ORD,MKE
AA920,1693659738,1693660325,587,12526,American Airlines,MKE,SFO
AA920,1693673835,1693680136,6301,5102,American Airlines,SFO,ORD
AA920,1693694616,1693694866,250,16787,American Airlines,ORD,MKE
AA920,1693715695,1693716758,1063,20342,American Airlines,MKE,LAX
AA920,1693741656,1693743331,1675,9477,American Airlines,LAX,SFO
AA920,1693758735,1693758998,263,7406,American Airlines,SFO,LAX
AA920,1693772923,1693773812,889,6346,American Airlines,LAX,SFO
AA920,1693781925,1693790841,8916,10523,American Airlines,SFO,ORD
AA920,1693805416,1693806307,891,7118,American Airlines,ORD,MKE
AA920,1693814462,1693814691,229,5419,American Airlines,MKE,LAX
AA920,1693824933,1693825824,891,3871,American Airlines,LAX,SFO
AA920,1693837025,1693841596,4571,21161,American Airlines,SFO,ORD
AA920,1693869705,1693870136,431,15559,American Airlines,ORD,MKE
AA920,1693887453,1693887685,232,9869,American Airlines,MKE,SFO
AA920,1693898763,1693904496,5733,11504,American Airlines,SFO,ORD
AA920,1693924470,1693925501,1031,4548,American Airlines,ORD,MKE
AA920,1693930395,1693930762,367,15713,American Airlines,MKE,LAX
AA920,1693951633,1693958372,6739,6701,American Airlines,LAX,ORD
AA920,1693965958,1693966939,981,14460,American Airlines,ORD,MKE
AA920,1693984746,1693989279,4533,14829,American Airlines,MKE,ORD
AA920,1694008224,1694009722,1498,11030,American Airlines,ORD,MKE
AA920,1694031340,1694041013,9673,9003,American Airlines,MKE,ORD
AA920,1694058188,1694059125,937,9319,American Airlines,ORD,MKE
AA920,1694070985,1694078143,7158,10191,American Airlines,MKE,ORD
AA920,1694098264,1694098794,530,20648,American Airlines,ORD,MKE
AA920,1694122262,1694122340,78,19101,American Airlines,MKE,SFO
AA920,1694152142,1694156782,4640,4545,American Airlines,SFO,ORD
AA920,1694165114,1694165946,832,17125,American Airlines,ORD,MKE
AA920,1694185384,1694185794,410,10751,American Airlines,MKE,LAX
AA920,1694198489,1694202349,3860,13653,American Airlines,LAX,ORD
AA920,1694218908,1694220610,1702,13334,American Airlines,ORD,MKE
AA920,1694234484,1694238327,3843,4390,American Airlines,MKE,ORD
AA920,1694243967,1694244300,333,9833,American Airlines,ORD,MKE
AA920,1694257174,1694257423,249,3767,American Airlines,MKE,SFO
AA920,1694261285,1694269483,8198,13904,American Airlines,SFO,ORD
AA920,1694283620,1694283815,195,8805,American Airlines,ORD,MKE
AA920,1694300914,1694304274,3360,14850,American Airlines,MKE,ORD
AA920,1694329250,1694329829,579,9936,American Airlines,ORD,MKE
AA920,1694348752,1694350363,1611,8636,American Airlines,MKE,LAX
AA920,1694359593,1694359949,356,17276,American Airlines,LAX,SFO
AA920,1694384122,1694392701,8579,8800,American Airlines,SFO,ORD
AA920,1694404606,1694405237,631,16004,American Airlines,ORD,MKE
AA920,1694429193,1694429397,204,19094,American Airlines,MKE,LAX
AA920,1694454860,1694456277,1417,3692,American Airlines,LAX,SFO
AA920,1694462614,1694463737,1123,20024,American Airlines,SFO,LAX
AA920,1694486312,1694487110,798,10341,American Airlines,LAX,SFO
AA920,1694502291,1694502530,239,9664,American Airlines,SFO,LAX
AA920,1694514718,1694519457,4739,7994,American Airlines,LAX,ORD
AA920,1694536642,1694537139,497,7156,American Airlines,ORD,MKE
AA920,1694548584,1694549402,818,9134,American Airlines,MKE,LAX
AA920,1694562696,1694562922,226,18077,American Airlines,LAX,SFO
AA920,1694583972,1694584640,668,19597,American Airlines,SFO,LAX
AA920,1694604663,1694611979,7316,12704,American Airlines,LAX,ORD
AA920,1694624706,1694626132,1426,9459,American Airlines,ORD,MKE
AA920,1694644333,1694645046,713,9430,American Airlines,MKE,LAX
AA920,1694660266,1694661855,1589,5766,American Airlines,LAX,SFO
AA920,1694674776,1694678991,4215,9599,American Airlines,SFO,ORD
AA920,1694690623,1694691889,1266,4800,American Airlines,ORD,MKE
AA920,1694699032,1694699109,77,19996,American Airlines,MKE,SFO
AA920,1694722459,1694728334,5875,6994,American Airlines,SFO,ORD
AA920,1694738750,1694739908,1158,20362,American Airlines,ORD,MKE
AA920,1694765067,1694768699,3632,10173,American Airlines,MKE,ORD
AA920,1694785145,1694785743,598,15421,American Airlines,ORD,MKE
AA920,1694802389,1694802992,603,5491,American Airlines,MKE,LAX
AA920,1694810688,1694811039,351,14098,American Airlines,LAX,SFO
AA920,1694835560,1694846359,10799,18535,American Airlines,SFO,ORD
AA920,1694867638,1694868031,393,15221,American Airlines,ORD,MKE
AA920,1694892275,1694892930,655,9596,American Airlines,MKE,LAX
AA920,1694907364,1694907539,175,7089,American Airlines,LAX,SFO
AA920,1694917911,1694920522,2611,10114,American Airlines,SFO,ORD
AA920,1694933794,1694935109,1315,16346,American Airlines,ORD,MKE
AA920,1694961306,1694962585,1279,13030,American Airlines,MKE,LAX
AA920,1694975958,1694986121,10163,17040,American Airlines,LAX,ORD
AA920,1695009932,1695010275,343,11994,American Airlines,ORD,MKE
AA920,1695028847,1695030067,1220,19383,American Airlines,MKE,SFO
AA920,1695056752,1695058453,1701,9294,American Airlines,SFO,LAX
AA920,1695075987,1695076191,204,10287,American Airlines,LAX,SFO
AA920,1695088580,1695095690,7110,12122,American Airlines,SFO,ORD
AA920,1695116497,1695117153,656,20712,American Airlines,ORD,MKE
AA920,1695140184,1695140901,717,14405,American Airlines,MKE,LAX
AA920,1695161277,1695167211,5934,17563,American Airlines,LAX,ORD
AA920,1695194501,1695195336,835,7584,American Airlines,ORD,MKE
AA920,1695203089,1695203738,649,17804,American Airlines,MKE,SFO
AA920,1695227925,1695228076,151,7295,American Airlines,SFO,LAX
AA920,1695239257,1695249088,9831,11799,American Airlines,LAX,ORD
AA920,1695264462,1695264843,381,14615,American Airlines,ORD,MKE
AA920,1695289712,1695290863,1151,12318,American Airlines,MKE,SFO
AA920,1695309429,1695309469,40,12823,American Airlines,SFO,LAX
AA920,1695329624,1695329795,171,9920,American Airlines,LAX,SFO
AA920,1695342697,1695352039,9342,7798,American Airlines,SFO,ORD
AA920,1695369065,1695370519,1454,11468,American Airlines,ORD,MKE
AA920,1695390857,1695400151,9294,10448,American Airlines,MKE,ORD
AA920,1695411149,1695411273,124,6821,American Airlines,ORD,MKE
AA920,1695428240,1695428725,485,17993,American Airlines,MKE,SFO
AA920,1695456008,1695465843,9835,20897,American Airlines,SFO,ORD
AA920,1695491315,1695491430,115,17413,American Airlines,ORD,MKE
AA920,1695515781,1695520274,4493,17743,American Airlines,MKE,ORD
AA920,1695544170,1695545951,1781,21176,American Airlines,ORD,MKE
AA920,1695569283,1695570737,1454,3675,American Airlines,MKE,SFO
AA920,1695579713,1695579745,32,9273,American Airlines,SFO,LAX
AA920,1695594534,1695595384,850,7741,American Airlines,LAX,SFO
AA920,1695603424,1695604038,614,19083,American Airlines,SFO,LAX
AA920,1695630851,1695631912,1061,7367,American Airlines,LAX,SFO
AA920,1695649820,1695650935,1115,15912,American Airlines,SFO,LAX
AA920,1695671632,1695675318,3686,10034,American Airlines,LAX,ORD
AA920,1695692672,1695694097,1425,15925,American Airlines,ORD,MKE
AA920,1695716366,1695716863,497,20206,American Airlines,MKE,LAX
AA920,1695739832,1695741240,1408,9894,American Airlines,LAX,SFO
AA920,1695754075,1695755986,1911,17241,American Airlines,SFO,ORD
AA920,1695775406,1695776810,1404,10697,American Airlines,ORD,MKE
AA920,1695791185,1695792378,1193,21233,American Airlines,MKE,LAX
AA920,1695814449,1695822423,7974,15913,American Airlines,LAX,ORD
AA920,1695843393,1695845090,1697,19456,American Airlines,ORD,MKE
AA920,1695874820,1695875742,922,17261,American Airlines,MKE,LAX
AA920,1695898047,1695900788,2741,4760,American Airlines,LAX,ORD
AA920,1695914517,1695915150,633,21025,American Airlines,ORD,MKE
AA920,1695940932,1695949838,8906,17033,American Airlines,MKE,ORD
AA920,1695966930,1695967032,102,9358,American Airlines,ORD,MKE
AA920,1695978146,1695979384,1238,16291,American Airlines,MKE,SFO
AA920,1695997531,1695997998,467,6950,American Airlines,SFO,LAX
AA920,1696010688,1696012167,1479,9352,American Airlines,LAX,SFO
AA920,1696030527,1696030544,17,11821,American Airlines,SFO,LAX
AA920,1696051120,1696052375,1255,7434,American Airlines,LAX,SFO
AA920,1696060380,1696062459,2079,12655,American Airlines,SFO,ORD
AA920,1696079045,1696080646,1601,21212,American Airlines,ORD,MKE
AA920,1696106320,1696106474,154,16992,American Airlines,MKE,SFO
AA920,1696127651,1696128968,1317,16053,American Airlines,SFO,LAX
AA920,1696149813,1696154726,4913,15560,American Airlines,LAX,ORD
AA920,1696178786,1696179714,928,10169,American Airlines,ORD,MKE
AA920,1696200373,1696201940,1567,7777,American Airlines,MKE,LAX
AA920,1696218399,1696219987,1588,6613,American Airlines,LAX,SFO
AA920,1696227068,1696236372,9304,15720,American Airlines,SFO,ORD
AA920,1696254540,1696255039,499,4094,American Airlines,ORD,MKE
AA920,1696265467,1696266712,1245,6892,American Airlines,MKE,SFO
AA920,1696280916,1696286175,5259,12098,American Airlines,SFO,ORD
AA920,1696301517,1696303294,1777,14593,American Airlines,ORD,MKE
AA920,1696322049,1696323541,1492,16931,American Airlines,MKE,SFO
AA920,1696350341,1696350846,505,20273,American Airlines,SFO,LAX
AA920,1696379802,1696381529,1727,17957,American Airlines,LAX,SFO
AA920,1696407320,1696418072,10752,17542,American Airlines,SFO,ORD
AA920,1696443895,1696445489,1594,10519,American Airlines,ORD,MKE
AA920,1696460286,1696469851,9565,12291,American Airlines,MKE,ORD
AA920,1696482433,1696482692,259,7598,American Airlines,ORD,MKE
AA920,1696500770,1696501718,948,19128,American Airlines,MKE,SFO
AA920,1696521944,1696522771,827,18250,American Airlines,SFO,LAX
AA920,1696550751,1696552042,1291,18220,American Airlines,LAX,SFO
AA920,1696577505,1696582258,4753,20165,American Airlines,SFO,ORD
AA920,1696609116,1696610096,980,21166,American Airlines,ORD,MKE
AA920,1696637386,1696638071,685,9154,American Airlines,MKE,SFO
AA920,1696649058,1696649099,41,13137,American Airlines,SFO,LAX
AA920,1696672424,1696680268,7844,5966,American Airlines,LAX,ORD
AA920,1696686773,1696687412,639,13814,American Airlines,ORD,MKE
AA920,1696709847,1696710516,669,18504,American Airlines,MKE,SFO
AA920,1696733101,1696733691,590,13859,American Airlines,SFO,LAX
AA920,1696752559,1696753330,771,6018,American Airlines,LAX,SFO
AA920,1696760645,1696771263,10618,12168,American Airlines,SFO,ORD
AA920,1696787100,1696787900,800,6697,American Airlines,ORD,MKE
AA920,1696795057,1696796524,1467,15730,American Airlines,MKE,LAX
AA920,1696814516,1696822170,7654,8473,American Airlines,LAX,ORD
AA920,1696837215,1696837932,717,8431,American Airlines,ORD,MKE
AA920,1696854057,1696855189,1132,19412,American Airlines,MKE,LAX
AA920,1696882458,1696883714,1256,18751,American Airlines,LAX,SFO
AA920,1696904842,1696905786,944,15958,American Airlines,SFO,LAX
AA920,1696925604,1696936189,10585,5872,American Airlines,LAX,ORD
AA920,1696950282,1696950763,481,13646,American Airlines,ORD,MKE
AA920,1696974138,1696977229,3091,16655,American Airlines,MKE,ORD
AA920,1697002408,1697003760,1352,16556,American Airlines,ORD,MKE
AA920,1697023305,1697030904,7599,18104,American Airlines,MKE,ORD
AA920,1697057015,1697058310,1295,8979,American Airlines,ORD,MKE
AA920,1697071360,1697072493,1133,10084,American Airlines,MKE,LAX
AA920,1697084530,1697086327,1797,9710,American Airlines,LAX,SFO
AA920,1697097494,1697097832,338,18208,American Airlines,SFO,LAX
AA920,1697119501,1697122535,3034,19408,American Airlines,LAX,ORD
AA920,1697145820,1697147319,1499,19330,American Airlines,ORD,MKE
AA920,1697170515,1697171074,559,11540,American Airlines,MKE,SFO
AA920,1697189139,1697192763,3624,16926,American Airlines,SFO,ORD
AA920,1697214527,1697216233,1706,12180,American Airlines,ORD,MKE
AA920,1697232930,1697238904,5974,8621,American Airlines,MKE,ORD
AA920,1697251494,1697252670,1176,16186,American Airlines,ORD,MKE
AA920,1697279033,1697280093,1060,16647,American Airlines,MKE,LAX
AA920,1697297493,1697298264,771,18015,American Airlines,LAX,SFO
AA920,1697321670,1697321920,250,18516,American Airlines,SFO,LAX
AA920,1697348352,1697357830,9478,21459,American Airlines,LAX,ORD
AA920,1697385399,1697386019,620,12063,American Airlines,ORD,MKE
AA920,1697407295,1697407470,175,14225,American Airlines,MKE,LAX
AA920,1697431899,1697435705,3806,20535,American Airlines,LAX,ORD
AA920,1697460041,1697461061,1020,14214,American Airlines,ORD,MKE
AA920,1697485385,1697485745,360,7941,American Airlines,MKE,LAX
AA920,1697498186,1697498554,368,11767,American Airlines,LAX,SFO
AA920,1697510670,1697511635,965,17829,American Airlines,SFO,LAX
AA920,1697534358,1697542649,8291,15093,American Airlines,LAX,ORD
AA920,1697562823,1697562964,141,11195,American Airlines,ORD,MKE
AA920,1697581196,1697585513,4317,19251,American Airlines,MKE,ORD
AA920,1697614743,1697615037,294,20371,American Airlines,ORD,MKE
AA920,1697636094,1697645754,9660,7640,American Airlines,MKE,ORD
AA920,1697655594,1697656087,493,10093,American Airlines,ORD,MKE
AA920,1697666454,1697671092,4638,8801,American Airlines,MKE,ORD
AA920,1697683702,1697685069,1367,12580,American Airlines,ORD,MKE
AA920,1697707729,1697709446,1717,12121,American Airlines,MKE,LAX
AA920,1697727637,1697731941,4304,18808,American Airlines,LAX,ORD
AA920,1697752406,1697752884,478,7882,American Airlines,ORD,MKE
AA920,1697764829,1697765362,533,14949,American Airlines,MKE,SFO
AA920,1697787901,1697789495,1594,18064,American Airlines,SFO,LAX
AA920,1697808379,1697817477,9098,21276,American Airlines,LAX,ORD
AA920,1697846608,1697848327,1719,10122,American Airlines,ORD,MKE
AA920,1697862032,1697866657,4625,6700,American Airlines,MKE,ORD
AA920,1697876410,1697876929,519,18349,American Airlines,ORD,MKE
AA920,1697899126,1697899396,270,4271,American Airlines,MKE,SFO
AA920,1697907492,1697907853,361,15410,American Airlines,SFO,LAX
AA920,1697931401,1697932190,789,12382,American Airlines,LAX,SFO
AA920,1697954957,1697956431,1474,21446,American Airlines,SFO,LAX
AA920,1697982181,1697983352,1171,16076,American Airlines,LAX,SFO
AA920,1698002019,1698003870,1851,18048,American Airlines,SFO,ORD
AA920,1698024095,1698025331,1236,4283,American Airlines,ORD,MKE
AA920,1698030496,1698033982,3486,14605,American Airlines,MKE,ORD
AA920,1698058873,1698059368,495,6343,American Airlines,ORD,MKE
AA920,1698072765,1698073602,837,18609,American Airlines,MKE,LAX
AA920,1698094345,1698095684,1339,7581,American Airlines,LAX,SFO
AA920,1698113528,1698115309,1781,13697,American Airlines,SFO,LAX
AA920,1698129700,1698135348,5648,13902,American Airlines,LAX,ORD
AA920,1698151277,1698152864,1587,7582,American Airlines,ORD,MKE
AA920,1698164901,1698166063,1162,18775,American Airlines,MKE,LAX
AA920,1698195222,1698200533,5311,13597,American Airlines,LAX,ORD
AA920,1698214997,1698215794,797,15382,American Airlines,ORD,MKE
AA920,1698233531,1698233537,6,4042,American Airlines,MKE,SFO
AA920,1698247503,1698247735,232,16362,American Airlines,SFO,LAX
AA920,1698265921,1698271788,5867,12977,American Airlines,LAX,ORD
AA920,1698293523,1698293677,154,8091,American Airlines,ORD,MKE
AA920,1698303136,1698303801,665,15763,American Airlines,MKE,SFO
AA920,1698325209,1698326275,1066,14154,American Airlines,SFO,LAX
AA920,1698346981,1698347628,647,9574,American Airlines,LAX,SFO
AA920,1698361332,1698367156,5824,16940,American Airlines,SFO,ORD
AA920,1698388010,1698389408,1398,9262,American Airlines,ORD,MKE
AA920,1698403809,1698411608,7799,6020,American Airlines,MKE,ORD
AA920,1698427736,1698428738,1002,6920,American Airlines,ORD,MKE
AA920,1698438645,1698442325,3680,9534,American Airlines,MKE,ORD
AA920,1698457041,1698457460,419,4964,American Airlines,ORD,MKE
AA920,1698466959,1698468568,1609,5214,American Airlines,MKE,SFO
AA920,1698476204,1698476634,430,14978,American Airlines,SFO,LAX
AA920,1698495518,1698496517,999,14918,American Airlines,LAX,SFO
DL526,1682959659,1682966580,6921,18497,Delta Air Lines,SFO,ORD
DL526,1682992766,1682992900,134,9559,Delta Air Lines,ORD,MKE
DL526,1683011211,1683011940,729,14548,Delta Air Lines,MKE,SFO
DL526,1683036396,1683043365,6969,18765,Delta Air Lines,SFO,ORD
DL526,1683064673,1683066027,1354,15515,Delta Air Lines,ORD,MKE
DL526,1683084525,1683087850,3325,18579,Delta Air Lines,MKE,ORD
DL526,1683114224,1683115443,1219,9027,Delta Air Lines,ORD,MKE
DL526,1683127931,1683129286,1355,15831,Delta Air Lines,MKE,SFO
DL526,1683148372,1683154556,6184,4399,Delta Air Lines,SFO,ORD
DL526,1683168169,1683168950,781,6358,Delta Air Lines,ORD,MKE
DL526,1683178804,1683179616,812,7182,Delta Air Lines,MKE,LAX
DL526,1683192881,1683193645,764,10500,Delta Air Lines,LAX,SFO
DL526,1683210211,1683211280,1069,7945,Delta Air Lines,SFO,LAX
DL526,1683222837,1683228115,5278,6764,Delta Air Lines,LAX,ORD
DL526,1683238143,1683238606,463,4934,Delta Air Lines,ORD,MKE
DL526,1683244558,1683249850,5292,6878,Delta Air Lines,MKE,ORD
DL526,1683261860,1683263398,1538,12209,Delta Air Lines,ORD,MKE
DL526,1683284966,1683285542,576,21128,Delta Air Lines,MKE,LAX
DL526,1683314708,1683321307,6599,10358,Delta Air Lines,LAX,ORD
DL526,1683336895,1683337190,295,15949,Delta Air Lines,ORD,MKE
DL526,1683359481,1683359835,354,5499,Delta Air Lines,MKE,SFO
DL526,1683367384,1683370816,3432,9175,Delta Air Lines,SFO,ORD
DL526,1683381253,1683382910,1657,17872,Delta Air Lines,ORD,MKE
DL526,1683411528,1683412699,1171,16927,Delta Air Lines,MKE,LAX
DL526,1683432111,1683434291,2180,9402,Delta Air Lines,LAX,ORD
DL526,1683446821,1683448582,1761,13818,Delta Air Lines,ORD,MKE
DL526,1683471359,1683474651,3292,5460,Delta Air Lines,MKE,ORD
DL526,1683481727,1683482298,571,18146,Delta Air Lines,ORD,MKE
DL526,1683505165,1683509840,4675,9260,Delta Air Lines,MKE,ORD
DL526,1683529339,1683531078,1739,14509,Delta Air Lines,ORD,MKE
DL526,1683548938,1683550448,1510,7323,Delta Air Lines,MKE,LAX
DL526,1683560872,1683562358,1486,9601,Delta Air Lines,LAX,SFO
DL526,1683580330,1683581401,1071,20269,Delta Air Lines,SFO,LAX
DL526,1683605242,1683606303,1061,15695,Delta Air Lines,LAX,SFO
DL526,1683629228,1683637560,8332,16131,Delta Air Lines,SFO,ORD
DL526,1683659738,1683660889,1151,12768,Delta Air Lines,ORD,MKE
DL526,1683682417,1683683269,852,21039,Delta Air Lines,MKE,SFO
DL526,1683711374,1683713384,2010,8726,Delta Air Lines,SFO,ORD
DL526,1683730499,1683730969,470,8794,Delta Air Lines,ORD,MKE
DL526,1683747851,1683751274,3423,8955,Delta Air Lines,MKE,ORD
DL526,1683765689,1683766494,805,11857,Delta Air Lines,ORD,MKE
DL526,1683778384,1683783779,5395,8027,Delta Air Lines,MKE,ORD
DL526,1683799257,1683800371,1114,4878,Delta Air Lines,ORD,MKE
DL526,1683815909,1683816349,440,8787,Delta Air Lines,MKE,SFO
DL526,1683832800,1683833483,683,19542,Delta Air Lines,SFO,LAX
DL526,1683856881,1683863365,6484,15233,Delta Air Lines,LAX,ORD
DL526,1683879370,1683880690,1320,5821,Delta Air Lines,ORD,MKE
DL526,1683896799,1683899883,3084,10228,Delta Air Lines,MKE,ORD
DL526,1683910311,1683911646,1335,15924,Delta Air Lines,ORD,MKE
DL526,1683934705,1683934979,274,16278,Delta Air Lines,MKE,LAX
DL526,1683959584,1683961146,1562,6059,Delta Air Lines,LAX,SFO
DL526,1683971942,1683975352,3410,19207,Delta Air Lines,SFO,ORD
DL526,1684002294,1684004024,1730,18525,Delta Air Lines,ORD,MKE
DL526,1684024102,1684024778,676,10426,Delta Air Lines,MKE,SFO
DL526,1684045860,1684049436,3576,3831,Delta Air Lines,SFO,ORD
DL526,1684063340,1684063760,420,7303,Delta Air Lines,ORD,MKE
DL526,1684071474,1684072758,1284,11511,Delta Air Lines,MKE,LAX
DL526,1684094731,1684102502,7771,4238,Delta Air Lines,LAX,ORD
DL526,1684107471,1684108544,1073,19647,Delta Air Lines,ORD,MKE
DL526,1684132438,1684141229,8791,19394,Delta Air Lines,MKE,ORD
DL526,1684162551,1684164137,1586,13773,Delta Air Lines,ORD,MKE
DL526,1684185639,1684187076,1437,9663,Delta Air Lines,MKE,SFO
DL526,1684198551,1684199243,692,7740,Delta Air Lines,SFO,LAX
DL526,1684209798,1684215637,5839,10911,Delta Air Lines,LAX,ORD
DL526,1684229517,1684231023,1506,5536,Delta Air Lines,ORD,MKE
DL526,1684243357,1684244068,711,14125,Delta Air Lines,MKE,SFO
DL526,1684259914,1684261291,1377,4480,Delta Air Lines,SFO,LAX
DL526,1684268340,1684273335,4995,12853,Delta Air Lines,LAX,ORD
DL526,1684287762,1684289029,1267,18060,Delta Air Lines,ORD,MKE
DL526,1684317129,1684318437,1308,18710,Delta Air Lines,MKE,SFO
DL526,1684337924,1684339655,1731,20362,Delta Air Lines,SFO,LAX
DL526,1684361796,1684364213,2417,3863,Delta Air Lines,LAX,ORD
DL526,1684370611,1684372337,1726,8927,Delta Air Lines,ORD,MKE
DL526,1684383443,1684384975,1532,7220,Delta Air Lines,MKE,SFO
DL526,1684402860,1684405645,2785,5440,Delta Air Lines,SFO,ORD
DL526,1684418723,1684419568,845,17296,Delta Air Lines,ORD,MKE
DL526,1684443358,1684445013,1655,15068,Delta Air Lines,MKE,LAX
DL526,1684465932,1684467838,1906,15694,Delta Air Lines,LAX,ORD
DL526,1684484384,1684485803,1419,13471,Delta Air Lines,ORD,MKE
DL526,1684499339,1684500627,1288,15816,Delta Air Lines,MKE,SFO
DL526,1684524589,1684526819,2230,17938,Delta Air Lines,SFO,ORD
DL526,1684553059,1684554305,1246,17353,Delta Air Lines,ORD,MKE
DL526,1684581062,1684582844,1782,7924,Delta Air Lines,MKE,LAX
DL526,1684597423,1684603218,5795,21207,Delta Air Lines,LAX,ORD
DL526,1684631285,1684632327,1042,15085,Delta Air Lines,ORD,MKE
DL526,1684651588,1684652222,634,17472,Delta Air Lines,MKE,LAX
DL526,1684670366,1684678254,7888,15756,Delta Air Lines,LAX,ORD
DL526,1684695704,1684695725,21,15449,Delta Air Lines,ORD,MKE
DL526,1684714005,1684715848,1843,13369,Delta Air Lines,MKE,ORD
DL526,1684732961,1684732989,28,7845,Delta Air Lines,ORD,MKE
DL526,1684742910,1684744224,1314,12947,Delta Air Lines,MKE,LAX
DL526,1684765445,1684775950,10505,5422,Delta Air Lines,LAX,ORD
DL526,1684792088,1684793826,1738,11363,Delta Air Lines,ORD,MKE
DL526,1684806558,1684807474,916,17346,Delta Air Lines,MKE,LAX
DL526,1684827999,1684831555,3556,4449,Delta Air Lines,LAX,ORD
DL526,1684836343,1684837898,1555,6051,Delta Air Lines,ORD,MKE
DL526,1684852153,1684862818,10665,5753,Delta Air Lines,MKE,ORD
DL526,1684879362,1684880501,1139,10021,Delta Air Lines,ORD,MKE
DL526,1684891712,1684898190,6478,9789,Delta Air Lines,MKE,ORD
DL526,1684915539,1684916130,591,8770,Delta Air Lines,ORD,MKE
DL526,1684931574,1684932771,1197,19109,Delta Air Lines,MKE,LAX
DL526,1684957742,1684963421,5679,18344,Delta Air Lines,LAX,ORD
DL526,1684984123,1684985098,975,17151,Delta Air Lines,ORD,MKE
DL526,1685004073,1685004306,233,14436,Delta Air Lines,MKE,SFO
DL526,1685027716,1685032239,4523,11815,Delta Air Lines,SFO,ORD
DL526,1685047383,1685048382,999,17210,Delta Air Lines,ORD,MKE
DL526,1685068626,1685069661,1035,11254,Delta Air Lines,MKE,SFO
DL526,1685088786,1685090397,1611,6912,Delta Air Lines,SFO,LAX
DL526,1685099015,1685099422,407,21281,Delta Air Lines,LAX,SFO
DL526,1685121299,1685129529,8230,18480,Delta Air Lines,SFO,ORD
DL526,1685153451,1685154446,995,12025,Delta Air Lines,ORD,MKE
DL526,1685171810,1685173292,1482,11824,Delta Air Lines,MKE,SFO
DL526,1685186686,1685188461,1775,13932,Delta Air Lines,SFO,LAX
DL526,1685206593,1685216802,10209,18031,Delta Air Lines,LAX,ORD
DL526,1685236871,1685237852,981,12010,Delta Air Lines,ORD,MKE
DL526,1685257711,1685257903,192,11875,Delta Air Lines,MKE,SFO
DL526,1685272102,1685278995,6893,18897,Delta Air Lines,SFO,ORD
DL526,1685305023,1685306570,1547,12985,Delta Air Lines,ORD,MKE
DL526,1685320070,1685323732,3662,17726,Delta Air Lines,MKE,ORD
DL526,1685351311,1685351840,529,16683,Delta Air Lines,ORD,MKE
DL526,1685372943,1685372993,50,4184,Delta Air Lines,MKE,LAX
DL526,1685380873,1685381262,389,13772,Delta Air Lines,LAX,SFO
DL526,1685401205,1685402490,1285,20316,Delta Air Lines,SFO,LAX
DL526,1685424262,1685429354,5092,9555,Delta Air Lines,LAX,ORD
DL526,1685441701,1685442579,878,17975,Delta Air Lines,ORD,MKE
DL526,1685468887,1685474902,6015,12663,Delta Air Lines,MKE,ORD
DL526,1685488945,1685489862,917,13161,Delta Air Lines,ORD,MKE
DL526,1685505213,1685506259,1046,12125,Delta Air Lines,MKE,LAX
DL526,1685528086,1685531445,3359,15799,Delta Air Lines,LAX,ORD
DL526,1685556450,1685556680,230,8785,Delta Air Lines,ORD,MKE
DL526,1685566052,1685567149,1097,13864,Delta Air Lines,MKE,LAX
DL526,1685586457,1685587977,1520,4041,Delta Air Lines,LAX,SFO
DL526,1685596670,1685597840,1170,9692,Delta Air Lines,SFO,LAX
DL526,1685609919,1685609942,23,18677,Delta Air Lines,LAX,SFO
DL526,1685631796,1685633583,1787,8042,Delta Air Lines,SFO,LAX
DL526,1685650637,1685654937,4300,9721,Delta Air Lines,LAX,ORD
DL526,1685670246,1685670355,109,5920,Delta Air Lines,ORD,MKE
DL526,1685679161,1685680790,1629,3967,Delta Air Lines,MKE,LAX
DL526,1685692409,1685692762,353,4711,Delta Air Lines,LAX,SFO
DL526,1685706689,1685708452,1763,4031,Delta Air Lines,SFO,LAX
DL526,1685719967,1685720727,760,13597,Delta Air Lines,LAX,SFO
DL526,1685740496,1685742221,1725,18407,Delta Air Lines,SFO,LAX
DL526,1685766794,1685767723,929,3977,Delta Air Lines,LAX,SFO
DL526,1685780261,1685788868,8607,11089,Delta Air Lines,SFO,ORD
DL526,1685810033,1685810724,691,18985,Delta Air Lines,ORD,MKE
DL526,1685837279,1685837864,585,11398,Delta Air Lines,MKE,LAX
DL526,1685859454,1685861675,2221,12648,Delta Air Lines,LAX,ORD
DL526,1685875335,1685875986,651,11380,Delta Air Lines,ORD,MKE
DL526,1685895118,1685895165,47,6562,Delta Air Lines,MKE,SFO
DL526,1685909335,1685909618,283,17938,Delta Air Lines,SFO,LAX
DL526,1685931028,1685939433,8405,11485,Delta Air Lines,LAX,ORD
DL526,1685952928,1685953714,786,8674,Delta Air Lines,ORD,MKE
DL526,1685970400,1685971419,1019,9177,Delta Air Lines,MKE,SFO
DL526,1685991163,1685992262,1099,5193,Delta Air Lines,SFO,LAX
DL526,1685999329,1686000370,1041,13171,Delta Air Lines,LAX,SFO
DL526,1686022884,1686023984,1100,10384,Delta Air Lines,SFO,LAX
DL526,1686037538,1686048052,10514,7142,Delta Air Lines,LAX,ORD
DL526,1686059005,1686060276,1271,7964,Delta Air Lines,ORD,MKE
DL526,1686075843,1686077855,2012,7714,Delta Air Lines,MKE,ORD
DL526,1686094982,1686095101,119,19963,Delta Air Lines,ORD,MKE
DL526,1686117609,1686117825,216,18373,Delta Air Lines,MKE,SFO
DL526,1686141213,1686151414,10201,19120,Delta Air Lines,SFO,ORD
DL526,1686178081,1686179070,989,6298,Delta Air Lines,ORD,MKE
DL526,1686189623,1686200379,10756,10495,Delta Air Lines,MKE,ORD
DL526,1686213359,1686214161,802,14065,Delta Air Lines,ORD,MKE
DL526,1686234672,1686236283,1611,3722,Delta Air Lines,MKE,SFO
DL526,1686248558,1686250175,1617,18850,Delta Air Lines,SFO,LAX
DL526,1686275362,1686281284,5922,20681,Delta Air Lines,LAX,ORD
DL526,1686307759,1686308463,704,14006,Delta Air Lines,ORD,MKE
DL526,1686323130,1686324798,1668,21334,Delta Air Lines,MKE,SFO
DL526,1686347964,1686349244,1280,9342,Delta Air Lines,SFO,LAX
DL526,1686363838,1686364182,344,5884,Delta Air Lines,LAX,SFO
DL526,1686380251,1686380389,138,14800,Delta Air Lines,SFO,LAX
DL526,1686395289,1686402051,6762,18569,Delta Air Lines,LAX,ORD
DL526,1686429819,1686430746,927,6980,Delta Air Lines,ORD,MKE
DL526,1686443613,1686445076,1463,8983,Delta Air Lines,MKE,SFO
DL526,1686462924,1686463915,991,14752,Delta Air Lines,SFO,LAX
DL526,1686480095,1686480520,425,18334,Delta Air Lines,LAX,SFO
DL526,1686507237,1686507997,760,17314,Delta Air Lines,SFO,LAX
DL526,1686526573,1686526717,144,15926,Delta Air Lines,LAX,SFO
DL526,1686542911,1686543922,1011,15227,Delta Air Lines,SFO,LAX
DL526,1686564076,1686565474,1398,8609,Delta Air Lines,LAX,SFO
DL526,1686579135,1686585751,6616,8774,Delta Air Lines,SFO,ORD
DL526,1686596619,1686596937,318,19364,Delta Air Lines,ORD,MKE
DL526,1686621451,1686625396,3945,18732,Delta Air Lines,MKE,ORD
DL526,1686646497,1686646573,76,4676,Delta Air Lines,ORD,MKE
DL526,1686652389,1686652626,237,19710,Delta Air Lines,MKE,SFO
DL526,1686680903,1686683646,2743,10590,Delta Air Lines,SFO,ORD
DL526,1686698615,1686699484,869,11300,Delta Air Lines,ORD,MKE
DL526,1686711662,1686712727,1065,16124,Delta Air Lines,MKE,LAX
DL526,1686730772,1686730883,111,10787,Delta Air Lines,LAX,SFO
DL526,1686747266,1686752210,4944,14963,Delta Air Lines,SFO,ORD
DL526,1686773101,1686773838,737,11698,Delta Air Lines,ORD,MKE
DL526,1686794256,1686794610,354,11075,Delta Air Lines,MKE,LAX
DL526,1686808703,1686809228,525,17035,Delta Air Lines,LAX,SFO
DL526,1686826740,1686827960,1220,4702,Delta Air Lines,SFO,LAX
DL526,1686836229,1686844869,8640,8673,Delta Air Lines,LAX,ORD
DL526,1686858994,1686860585,1591,6589,Delta Air Lines,ORD,MKE
DL526,1686877202,1686886260,9058,15453,Delta Air Lines,MKE,ORD
DL526,1686905095,1686906218,1123,5886,Delta Air Lines,ORD,MKE
DL526,1686922891,1686929579,6688,21099,Delta Air Lines,MKE,ORD
DL526,1686960491,1686961925,1434,20527,Delta Air Lines,ORD,MKE
DL526,1686989472,1686996216,6744,12843,Delta Air Lines,MKE,ORD
DL526,1687016887,1687017899,1012,19988,Delta Air Lines,ORD,MKE
DL526,1687037963,1687040833,2870,13053,Delta Air Lines,MKE,ORD
DL526,1687058548,1687059429,881,14823,Delta Air Lines,ORD,MKE
DL526,1687082134,1687092071,9937,18754,Delta Air Lines,MKE,ORD
DL526,1687119976,1687121192,1216,8221,Delta Air Lines,ORD,MKE
DL526,1687134281,1687134823,542,13366,Delta Air Lines,MKE,SFO
DL526,1687150870,1687154277,3407,4789,Delta Air Lines,SFO,ORD
DL526,1687167091,1687167576,485,17409,Delta Air Lines,ORD,MKE
DL526,1687190496,1687191227,731,6713,Delta Air Lines,MKE,SFO
DL526,1687204230,1687204951,721,19229,Delta Air Lines,SFO,LAX
DL526,1687224181,1687224500,319,18721,Delta Air Lines,LAX,SFO
DL526,1687247553,1687257506,9953,15277,Delta Air Lines,SFO,ORD
DL526,1687275545,1687276648,1103,6407,Delta Air Lines,ORD,MKE
DL526,1687288523,1687289688,1165,5938,Delta Air Lines,MKE,SFO
DL526,1687300887,1687301392,505,13959,Delta Air Lines,SFO,LAX
DL526,1687315946,1687317588,1642,19338,Delta Air Lines,LAX,SFO
DL526,1687342646,1687351151,8505,6727,Delta Air Lines,SFO,ORD
DL526,1687363260,1687363997,737,5752,Delta Air Lines,ORD,MKE
DL526,1687377600,1687378950,1350,19919,Delta Air Lines,MKE,LAX
DL526,1687406307,1687406410,103,7647,Delta Air Lines,LAX,SFO
DL526,1687419751,1687421075,1324,15640,Delta Air Lines,SFO,LAX
DL526,1687437677,1687438231,554,10874,Delta Air Lines,LAX,SFO
DL526,1687455344,1687461256,5912,8769,Delta Air Lines,SFO,ORD
DL526,1687479263,1687480766,1503,15298,Delta Air Lines,ORD,MKE
DL526,1687502720,1687502897,177,18789,Delta Air Lines,MKE,SFO
DL526,1687529514,1687530632,1118,10772,Delta Air Lines,SFO,LAX
DL526,1687550279,1687551995,1716,10177,Delta Air Lines,LAX,SFO
DL526,1687567500,1687569219,1719,3624,Delta Air Lines,SFO,LAX
DL526,1687575381,1687584393,9012,9789,Delta Air Lines,LAX,ORD
DL526,1687594570,1687594700,130,17470,Delta Air Lines,ORD,MKE
DL526,1687615132,1687615687,555,7764,Delta Air Lines,MKE,LAX
DL526,1687631948,1687633632,1684,9548,Delta Air Lines,LAX,SFO
DL526,1687652094,1687659146,7052,6100,Delta Air Lines,SFO,ORD
DL526,1687667675,1687669436,1761,20432,Delta Air Lines,ORD,MKE
DL526,1687698582,1687703122,4540,8634,Delta Air Lines,MKE,ORD
DL526,1687713937,1687713949,12,11822,Delta Air Lines,ORD,MKE
DL526,1687731605,1687731942,337,21264,Delta Air Lines,MKE,SFO
DL526,1687757769,1687758304,535,7756,Delta Air Lines,SFO,LAX
DL526,1687768058,1687768304,246,12139,Delta Air Lines,LAX,SFO
DL526,1687781446,1687782463,1017,12423,Delta Air Lines,SFO,LAX
DL526,1687805011,1687814235,9224,19297,Delta Air Lines,LAX,ORD
DL526,1687840518,1687841150,632,12854,Delta Air Lines,ORD,MKE
DL526,1687861141,1687862657,1516,17248,Delta Air Lines,MKE,LAX
DL526,1687890250,1687900762,10512,16338,Delta Air Lines,LAX,ORD
DL526,1687924893,1687926079,1186,7319,Delta Air Lines,ORD,MKE
DL526,1687943607,1687945186,1579,5080,Delta Air Lines,MKE,SFO
DL526,1687950372,1687956070,5698,12860,Delta Air Lines,SFO,ORD
DL526,1687969295,1687970107,812,15234,Delta Air Lines,ORD,MKE
DL526,1687988197,1687989623,1426,21525,Delta Air Lines,MKE,SFO
DL526,1688014319,1688024800,10481,18107,Delta Air Lines,SFO,ORD
DL526,1688048288,1688048551,263,11538,Delta Air Lines,ORD,MKE
DL526,1688068173,1688077887,9714,6800,Delta Air Lines,MKE,ORD
DL526,1688091568,1688091896,328,17089,Delta Air Lines,ORD,MKE
DL526,1688117646,1688119166,1520,4675,Delta Air Lines,MKE,SFO
DL526,1688131514,1688135286,3772,11265,Delta Air Lines,SFO,ORD
DL526,1688152850,1688154321,1471,14910,Delta Air Lines,ORD,MKE
DL526,1688177883,1688178751,868,13563,Delta Air Lines,MKE,LAX
DL526,1688193753,1688201209,7456,16487,Delta Air Lines,LAX,ORD
DL526,1688219968,1688220005,37,6659,Delta Air Lines,ORD,MKE
DL526,1688230495,1688230523,28,8474,Delta Air Lines,MKE,LAX
DL526,1688244224,1688253772,9548,13792,Delta Air Lines,LAX,ORD
DL526,1688275472,1688275588,116,8195,Delta Air Lines,ORD,MKE
DL526,1688287036,1688296723,9687,17250,Delta Air Lines,MKE,ORD
DL526,1688318853,1688320532,1679,17095,Delta Air Lines,ORD,MKE
DL526,1688344377,1688345177,800,18701,Delta Air Lines,MKE,LAX
DL526,1688371324,1688372861,1537,21571,Delta Air Lines,LAX,SFO
DL526,1688394618,1688396279,1661,6959,Delta Air Lines,SFO,LAX
DL526,1688403787,1688410778,6991,19511,Delta Air Lines,LAX,ORD
DL526,1688431763,1688432249,486,16162,Delta Air Lines,ORD,MKE
DL526,1688450102,1688450379,277,19390,Delta Air Lines,MKE,LAX
DL526,1688475516,1688476814,1298,9408,Delta Air Lines,LAX,SFO
DL526,1688496544,1688502311,5767,18721,Delta Air Lines,SFO,ORD
DL526,1688521980,1688522300,320,17421,Delta Air Lines,ORD,MKE
DL526,1688543854,1688544683,829,15084,Delta Air Lines,MKE,LAX
DL526,1688568979,1688571064,2085,3914,Delta Air Lines,LAX,ORD
DL526,1688578018,1688579060,1042,13260,Delta Air Lines,ORD,MKE
DL526,1688600203,1688608692,8489,9551,Delta Air Lines,MKE,ORD
DL526,1688625139,1688625642,503,9514,Delta Air Lines,ORD,MKE
DL526,1688642489,1688642871,382,15013,Delta Air Lines,MKE,LAX
DL526,1688666571,1688667107,536,11811,Delta Air Lines,LAX,SFO
DL526,1688683227,1688692559,9332,17950,Delta Air Lines,SFO,ORD
DL526,1688720505,1688720905,400,17749,Delta Air Lines,ORD,MKE
DL526,1688741124,1688741802,678,7425,Delta Air Lines,MKE,SFO
DL526,1688756326,1688758395,2069,10514,Delta Air Lines,SFO,ORD
DL526,1688779448,1688780947,1499,7566,Delta Air Lines,ORD,MKE
DL526,1688794065,1688795566,1501,16661,Delta Air Lines,MKE,LAX
DL526,1688819890,1688825696,5806,14957,Delta Air Lines,LAX,ORD
DL526,1688849221,1688850411,1190,14166,Delta Air Lines,ORD,MKE
DL526,1688871175,1688876834,5659,6086,Delta Air Lines,MKE,ORD
DL526,1688888524,1688888652,128,5353,Delta Air Lines,ORD,MKE
DL526,1688897691,1688902343,4652,9797,Delta Air Lines,MKE,ORD
DL526,1688914142,1688914622,480,5340,Delta Air Lines,ORD,MKE
DL526,1688923432,1688925215,1783,17808,Delta Air Lines,MKE,SFO
DL526,1688951842,1688957956,6114,13194,Delta Air Lines,SFO,ORD
DL526,1688975433,1688976050,617,15298,Delta Air Lines,ORD,MKE
DL526,1688991498,1688991872,374,21577,Delta Air Lines,MKE,LAX
DL526,1689023529,1689026637,3108,17646,Delta Air Lines,LAX,ORD
DL526,1689051097,1689052407,1310,17587,Delta Air Lines,ORD,MKE
DL526,1689079400,1689080043,643,10521,Delta Air Lines,MKE,LAX
DL526,1689100265,1689110433,10168,12947,Delta Air Lines,LAX,ORD
DL526,1689126193,1689127871,1678,20927,Delta Air Lines,ORD,MKE
DL526,1689158152,1689159366,1214,21099,Delta Air Lines,MKE,SFO
DL526,1689184658,1689194438,9780,3867,Delta Air Lines,SFO,ORD
DL526,1689202026,1689202647,621,9210,Delta Air Lines,ORD,MKE
DL526,1689221745,1689232113,10368,21152,Delta Air Lines,MKE,ORD
DL526,1689263084,1689264477,1393,12148,Delta Air Lines,ORD,MKE
DL526,1689278581,1689279150,569,10086,Delta Air Lines,MKE,LAX
DL526,1689296345,1689304637,8292,9046,Delta Air Lines,LAX,ORD
DL526,1689316098,1689317522,1424,13574,Delta Air Lines,ORD,MKE
DL526,1689339782,1689340281,499,15581,Delta Air Lines,MKE,LAX
DL526,1689361108,1689363433,2325,12801,Delta Air Lines,LAX,ORD
DL526,1689380895,1689381586,691,9887,Delta Air Lines,ORD,MKE
DL526,1689398213,1689399559,1346,15699,Delta Air Lines,MKE,SFO
DL526,1689423704,1689424585,881,15297,Delta Air Lines,SFO,LAX
DL526,1689440864,1689442322,1458,20611,Delta Air Lines,LAX,SFO
DL526,1689469261,1689469299,38,8554,Delta Air Lines,SFO,LAX
DL526,1689480227,1689486648,6421,14080,Delta Air Lines,LAX,ORD
DL526,1689508572,1689509539,967,14732,Delta Air Lines,ORD,MKE
DL526,1689525205,1689532606,7401,21309,Delta Air Lines,MKE,ORD
DL526,1689562497,1689563201,704,4204,Delta Air Lines,ORD,MKE
DL526,1689576701,1689577174,473,13569,Delta Air Lines,MKE,LAX
DL526,1689599114,1689601915,2801,17998,Delta Air Lines,LAX,ORD
DL526,1689619943,1689620174,231,17922,Delta Air Lines,ORD,MKE
DL526,1689648254,1689655628,7374,21476,Delta Air Lines,MKE,ORD
DL526,1689687194,1689687742,548,17315,Delta Air Lines,ORD,MKE
DL526,1689709301,1689711103,1802,17471,Delta Air Lines,MKE,ORD
DL526,1689729167,1689729533,366,4723,Delta Air Lines,ORD,MKE
DL526,1689741685,1689742280,595,14741,Delta Air Lines,MKE,SFO
DL526,1689757121,1689758126,1005,4415,Delta Air Lines,SFO,LAX
DL526,1689764733,1689765212,479,4522,Delta Air Lines,LAX,SFO
DL526,1689778133,1689783159,5026,4506,Delta Air Lines,SFO,ORD
DL526,1689792276,1689792327,51,10185,Delta Air Lines,ORD,MKE
DL526,1689805086,1689813248,8162,13961,Delta Air Lines,MKE,ORD
DL526,1689834581,1689835137,556,21192,Delta Air Lines,ORD,MKE
DL526,1689859590,1689859814,224,16223,Delta Air Lines,MKE,SFO
DL526,1689876540,1689881374,4834,13644,Delta Air Lines,SFO,ORD
DL526,1689895740,1689896333,593,5310,Delta Air Lines,ORD,MKE
DL526,1689907294,1689912714,5420,14626,Delta Air Lines,MKE,ORD
DL526,1689928750,1689929478,728,6779,Delta Air Lines,ORD,MKE
DL526,1689945658,1689947333,1675,15713,Delta Air Lines,MKE,LAX
DL526,1689968317,1689969788,1471,15567,Delta Air Lines,LAX,SFO
DL526,1689995038,1689995415,377,12054,Delta Air Lines,SFO,LAX
DL526,1690015811,1690019278,3467,9995,Delta Air Lines,LAX,ORD
DL526,1690037936,1690039481,1545,20114,Delta Air Lines,ORD,MKE
DL526,1690061911,1690063159,1248,12250,Delta Air Lines,MKE,LAX
DL526,1690086028,1690088599,2571,16662,Delta Air Lines,LAX,ORD
DL526,1690113331,1690113491,160,4363,Delta Air Lines,ORD,MKE
DL526,1690125694,1690134306,8612,3749,Delta Air Lines,MKE,ORD
DL526,1690142204,1690142821,617,12511,Delta Air Lines,ORD,MKE
DL526,1690162349,1690162877,528,7567,Delta Air Lines,MKE,SFO
DL526,1690178733,1690179582,849,4051,Delta Air Lines,SFO,LAX
DL526,1690186217,1690190891,4674,20399,Delta Air Lines,LAX,ORD
DL526,1690218205,1690218830,625,5999,Delta Air Lines,ORD,MKE
DL526,1690231154,1690236176,5022,14978,Delta Air Lines,MKE,ORD
DL526,1690251566,1690252604,1038,17392,Delta Air Lines,ORD,MKE
DL526,1690278363,1690279632,1269,15463,Delta Air Lines,MKE,SFO
DL526,1690295866,1690302857,6991,17983,Delta Air Lines,SFO,ORD
DL526,1690328850,1690329490,640,21450,Delta Air Lines,ORD,MKE
DL526,1690359483,1690361219,1736,17391,Delta Air Lines,MKE,LAX
DL526,1690383524,1690389060,5536,21557,Delta Air Lines,LAX,ORD
DL526,1690419457,1690421179,1722,17453,Delta Air Lines,ORD,MKE
DL526,1690441210,1690443086,1876,7641,Delta Air Lines,MKE,ORD
DL526,1690459654,1690460351,697,4622,Delta Air Lines,ORD,MKE
DL526,1690475771,1690476141,370,11970,Delta Air Lines,MKE,LAX
DL526,1690491543,1690491566,23,16073,Delta Air Lines,LAX,SFO
DL526,1690513467,1690520178,6711,4713,Delta Air Lines,SFO,ORD
DL526,1690525264,1690525822,558,16701,Delta Air Lines,ORD,MKE
DL526,1690550948,1690551516,568,4285,Delta Air Lines,MKE,SFO
DL526,1690556447,1690567135,10688,12603,Delta Air Lines,SFO,ORD
DL526,1690586532,1690587440,908,15157,Delta Air Lines,ORD,MKE
DL526,1690612767,1690612894,127,8785,Delta Air Lines,MKE,LAX
DL526,1690627957,1690629556,1599,10378,Delta Air Lines,LAX,SFO
DL526,1690645106,1690651404,6298,10240,Delta Air Lines,SFO,ORD
DL526,1690663036,1690663522,486,8370,Delta Air Lines,ORD,MKE
DL526,1690679598,1690680331,733,13518,Delta Air Lines,MKE,LAX
DL526,1690702581,1690703288,707,10082,Delta Air Lines,LAX,SFO
DL526,1690721359,1690723614,2255,12515,Delta Air Lines,SFO,ORD
DL526,1690739269,1690740786,1517,19087,Delta Air Lines,ORD,MKE
DL526,1690765268,1690765994,726,14579,Delta Air Lines,MKE,LAX
DL526,1690787912,1690788536,624,8568,Delta Air Lines,LAX,SFO
DL526,1690797129,1690797648,519,20972,Delta Air Lines,SFO,LAX
DL526,1690820224,1690828322,8098,17347,Delta Air Lines,LAX,ORD
DL526,1690848039,1690848900,861,16773,Delta Air Lines,ORD,MKE
DL526,1690868645,1690870485,1840,5864,Delta Air Lines,MKE,ORD
DL526,1690883752,1690884734,982,7231,Delta Air Lines,ORD,MKE
DL526,1690892182,1690900781,8599,8264,Delta Air Lines,MKE,ORD
DL526,1690913827,1690914223,396,6600,Delta Air Lines,ORD,MKE
DL526,1690928880,1690930304,1424,20026,Delta Air Lines,MKE,SFO
DL526,1690950438,1690953751,3313,11347,Delta Air Lines,SFO,ORD
DL526,1690974990,1690975616,626,10891,Delta Air Lines,ORD,MKE
DL526,1690995358,1691001546,6188,6971,Delta Air Lines,MKE,ORD
DL526,1691013907,1691015413,1506,7383,Delta Air Lines,ORD,MKE
DL526,1691031901,1691033189,1288,21111,Delta Air Lines,MKE,LAX
DL526,1691063076,1691066256,3180,17663,Delta Air Lines,LAX,ORD
DL526,1691088985,1691090755,1770,19640,Delta Air Lines,ORD,MKE
DL526,1691118685,1691120483,1798,6747,Delta Air Lines,MKE,SFO
DL526,1691131793,1691133194,1401,4957,Delta Air Lines,SFO,LAX
DL526,1691138462,1691138683,221,6006,Delta Air Lines,LAX,SFO
DL526,1691150584,1691152248,1664,11345,Delta Air Lines,SFO,LAX
DL526,1691167211,1691169838,2627,3883,Delta Air Lines,LAX,ORD
DL526,1691177472,1691177669,197,10508,Delta Air Lines,ORD,MKE
DL526,1691197921,1691204970,7049,16856,Delta Air Lines,MKE,ORD
DL526,1691227934,1691228422,488,12774,Delta Air Lines,ORD,MKE
DL526,1691247668,1691248025,357,19332,Delta Air Lines,MKE,LAX
DL526,1691270358,1691270892,534,13996,Delta Air Lines,LAX,SFO
DL526,1691286251,1691292412,6161,21351,Delta Air Lines,SFO,ORD
DL526,1691314006,1691315620,1614,8154,Delta Air Lines,ORD,MKE
DL526,1691329530,1691334774,5244,17357,Delta Air Lines,MKE,ORD
DL526,1691355890,1691357176,1286,20665,Delta Air Lines,ORD,MKE
DL526,1691381396,1691383039,1643,19036,Delta Air Lines,MKE,LAX
DL526,1691405292,1691407487,2195,13892,Delta Air Lines,LAX,ORD
DL526,1691426568,1691427290,722,19442,Delta Air Lines,ORD,MKE
DL526,1691453397,1691454352,955,4252,Delta Air Lines,MKE,LAX
DL526,1691461108,1691465629,4521,4306,Delta Air Lines,LAX,ORD
DL526,1691474111,1691474706,595,7977,Delta Air Lines,ORD,MKE
DL526,1691486810,1691487191,381,3941,Delta Air Lines,MKE,SFO
DL526,1691497767,1691498522,755,5235,Delta Air Lines,SFO,LAX
DL526,1691505351,1691506372,1021,20730,Delta Air Lines,LAX,SFO
DL526,1691537059,1691543849,6790,15963,Delta Air Lines,SFO,ORD
DL526,1691568438,1691569860,1422,20997,Delta Air Lines,ORD,MKE
DL526,1691590983,1691592935,1952,18449,Delta Air Lines,MKE,ORD
DL526,1691611736,1691613420,1684,15097,Delta Air Lines,ORD,MKE
DL526,1691628660,1691629306,646,20451,Delta Air Lines,MKE,SFO
DL526,1691651820,1691653117,1297,5667,Delta Air Lines,SFO,LAX
DL526,1691668808,1691679020,10212,9153,Delta Air Lines,LAX,ORD
DL526,1691697458,1691698047,589,16631,Delta Air Lines,ORD,MKE
DL526,1691720820,1691730329,9509,10732,Delta Air Lines,MKE,ORD
DL526,1691749376,1691750127,751,18365,Delta Air Lines,ORD,MKE
DL526,1691771571,1691772165,594,6412,Delta Air Lines,MKE,SFO
DL526,1691778989,1691780287,1298,4670,Delta Air Lines,SFO,LAX
DL526,1691794782,1691796038,1256,13615,Delta Air Lines,LAX,SFO
DL526,1691811119,1691820226,9107,17838,Delta Air Lines,SFO,ORD
DL526,1691848842,1691849211,369,16034,Delta Air Lines,ORD,MKE
DL526,1691872660,1691879181,6521,4321,Delta Air Lines,MKE,ORD
DL526,1691894018,1691894849,831,9596,Delta Air Lines,ORD,MKE
DL526,1691910104,1691911268,1164,8633,Delta Air Lines,MKE,LAX
DL526,1691925040,1691925715,675,6098,Delta Air Lines,LAX,SFO
DL526,1691939731,1691941706,1975,7225,Delta Air Lines,SFO,ORD
DL526,1691954414,1691955159,745,15734,Delta Air Lines,ORD,MKE
DL526,1691971635,1691972747,1112,19005,Delta Air Lines,MKE,SFO
DL526,1691994783,1692002902,8119,5138,Delta Air Lines,SFO,ORD
DL526,1692014121,1692014505,384,4116,Delta Air Lines,ORD,MKE
DL526,1692023601,1692024470,869,18374,Delta Air Lines,MKE,SFO
DL526,1692052192,1692052221,29,6325,Delta Air Lines,SFO,LAX
DL526,1692068708,1692071848,3140,13156,Delta Air Lines,LAX,ORD
DL526,1692093747,1692094916,1169,15110,Delta Air Lines,ORD,MKE
DL526,1692120769,1692126207,5438,7945,Delta Air Lines,MKE,ORD
DL526,1692144523,1692145864,1341,3735,Delta Air Lines,ORD,MKE
DL526,1692156245,1692157109,864,8475,Delta Air Lines,MKE,SFO
DL526,1692174417,1692174573,156,15257,Delta Air Lines,SFO,LAX
DL526,1692198781,1692200167,1386,12921,Delta Air Lines,LAX,SFO
DL526,1692215444,1692218795,3351,9138,Delta Air Lines,SFO,ORD
DL526,1692229040,1692229915,875,6196,Delta Air Lines,ORD,MKE
DL526,1692241551,1692242229,678,7952,Delta Air Lines,MKE,SFO
DL526,1692253739,1692258307,4568,12733,Delta Air Lines,SFO,ORD
DL526,1692272225,1692272325,100,18736,Delta Air Lines,ORD,MKE
DL526,1692298119,1692299721,1602,6389,Delta Air Lines,MKE,SFO
DL526,1692310597,1692315478,4881,11514,Delta Air Lines,SFO,ORD
DL526,1692331093,1692331346,253,9700,Delta Air Lines,ORD,MKE
DL526,1692351249,1692351807,558,4215,Delta Air Lines,MKE,LAX
DL526,1692363138,1692373420,10282,13817,Delta Air Lines,LAX,ORD
DL526,1692392818,1692393896,1078,8654,Delta Air Lines,ORD,MKE
DL526,1692412996,1692421677,8681,4522,Delta Air Lines,MKE,ORD
DL526,1692434848,1692434941,93,14106,Delta Air Lines,ORD,MKE
DL526,1692450735,1692453873,3138,7682,Delta Air Lines,MKE,ORD
DL526,1692471586,1692473161,1575,9298,Delta Air Lines,ORD,MKE
DL526,1692483746,1692484861,1115,4742,Delta Air Lines,MKE,SFO
DL526,1692498868,1692508547,9679,4196,Delta Air Lines,SFO,ORD
DL526,1692517110,1692517546,436,11395,Delta Air Lines,ORD,MKE
DL526,1692539340,1692540758,1418,17717,Delta Air Lines,MKE,SFO
DL526,1692564160,1692565208,1048,19101,Delta Air Lines,SFO,LAX
DL526,1692591280,1692595792,4512,3845,Delta Air Lines,LAX,ORD
DL526,1692604897,1692606198,1301,11228,Delta Air Lines,ORD,MKE
DL526,1692619456,1692624918,5462,12412,Delta Air Lines,MKE,ORD
DL526,1692644226,1692645166,940,4581,Delta Air Lines,ORD,MKE
DL526,1692652531,1692653396,865,19746,Delta Air Lines,MKE,LAX
DL526,1692676473,1692680457,3984,8977,Delta Air Lines,LAX,ORD
DL526,1692700100,1692701258,1158,13829,Delta Air Lines,ORD,MKE
DL526,1692720546,1692720929,383,16335,Delta Air Lines,MKE,LAX
DL526,1692738586,1692747229,8643,9824,Delta Air Lines,LAX,ORD
DL526,1692761494,1692763155,1661,8257,Delta Air Lines,ORD,MKE
DL526,1692781015,1692782649,1634,8937,Delta Air Lines,MKE,LAX
DL526,1692793773,1692794525,752,6790,Delta Air Lines,LAX,SFO
DL526,1692811709,1692813092,1383,5231,Delta Air Lines,SFO,LAX
DL526,1692827413,1692829078,1665,7734,Delta Air Lines,LAX,SFO
DL526,1692837346,1692838472,1126,17604,Delta Air Lines,SFO,LAX
DL526,1692860306,1692860705,399,10086,Delta Air Lines,LAX,SFO
DL526,1692876664,1692884674,8010,5263,Delta Air Lines,SFO,ORD
DL526,1692894452,1692894950,498,9518,Delta Air Lines,ORD,MKE
DL526,1692906046,1692907137,1091,20600,Delta Air Lines,MKE,SFO
DL526,1692931894,1692941833,9939,20570,Delta Air Lines,SFO,ORD
DL526,1692963221,1692963572,351,14072,Delta Air Lines,ORD,MKE
DL526,1692979873,1692987890,8017,13746,Delta Air Lines,MKE,ORD
DL526,1693006284,1693007471,1187,20778,Delta Air Lines,ORD,MKE
DL526,1693031345,1693032297,952,10736,Delta Air Lines,MKE,SFO
DL526,1693043241,1693053975,10734,12394,Delta Air Lines,SFO,ORD
DL526,1693066703,1693068255,1552,16943,Delta Air Lines,ORD,MKE
DL526,1693090660,1693094397,3737,5957,Delta Air Lines,MKE,ORD
DL526,1693106743,1693106943,200,14100,Delta Air Lines,ORD,MKE
DL526,1693130928,1693138399,7471,6383,Delta Air Lines,MKE,ORD
DL526,1693153454,1693154637,1183,10320,Delta Air Lines,ORD,MKE
DL526,1693169851,1693170490,639,5307,Delta Air Lines,MKE,LAX
DL526,1693177705,1693177732,27,17530,Delta Air Lines,LAX,SFO
DL526,1693203553,1693213539,9986,11426,Delta Air Lines,SFO,ORD
DL526,1693235000,1693235692,692,18901,Delta Air Lines,ORD,MKE
DL526,1693264553,1693264682,129,4773,Delta Air Lines,MKE,LAX
DL526,1693270762,1693280509,9747,3868,Delta Air Lines,LAX,ORD
DL526,1693286582,1693286717,135,13532,Delta Air Lines,ORD,MKE
DL526,1693302134,1693309250,7116,11345,Delta Air Lines,MKE,ORD
DL526,1693324630,1693326399,1769,14510,Delta Air Lines,ORD,MKE
DL526,1693344871,1693348973,4102,9413,Delta Air Lines,MKE,ORD
DL526,1693365614,1693366616,1002,3884,Delta Air Lines,ORD,MKE
DL526,1693371324,1693372942,1618,8580,Delta Air Lines,MKE,SFO
DL526,1693384079,1693393114,9035,8660,Delta Air Lines,SFO,ORD
DL526,1693405730,1693406392,662,4673,Delta Air Lines,ORD,MKE
DL526,1693414308,1693415461,1153,5257,Delta Air Lines,MKE,SFO
DL526,1693430687,1693433030,2343,4462,Delta Air Lines,SFO,ORD
DL526,1693444390,1693445856,1466,7778,Delta Air Lines,ORD,MKE
DL526,1693458630,1693458871,241,20382,Delta Air Lines,MKE,LAX
DL526,1693489245,1693493513,4268,7821,Delta Air Lines,LAX,ORD
DL526,1693504045,1693505114,1069,14579,Delta Air Lines,ORD,MKE
DL526,1693521745,1693530664,8919,15523,Delta Air Lines,MKE,ORD
DL526,1693553927,1693554974,1047,18495,Delta Air Lines,ORD,MKE
DL526,1693581974,1693583319,1345,4312,Delta Air Lines,MKE,SFO
DL526,1693591499,1693593407,1908,5594,Delta Air Lines,SFO,ORD
DL526,1693602810,1693603300,490,16237,Delta Air Lines,ORD,MKE
DL526,1693627219,1693628804,1585,12899,Delta Air Lines,MKE,LAX
DL526,1693649452,1693655986,6534,15742,Delta Air Lines,LAX,ORD
DL526,1693674537,1693675917,1380,12257,Delta Air Lines,ORD,MKE
DL526,1693697691,1693698265,574,9512,Delta Air Lines,MKE,SFO
DL526,1693712929,1693720203,7274,11949,Delta Air Lines,SFO,ORD
DL526,1693739342,1693740579,1237,18389,Delta Air Lines,ORD,MKE
DL526,1693768638,1693769753,1115,10695,Delta Air Lines,MKE,SFO
DL526,1693784158,1693785241,1083,10684,Delta Air Lines,SFO,LAX
DL526,1693801182,1693801523,341,11792,Delta Air Lines,LAX,SFO
DL526,1693823124,1693827956,4832,16565,Delta Air Lines,SFO,ORD
DL526,1693854061,1693854361,300,19010,Delta Air Lines,ORD,MKE
DL526,1693874756,1693874922,166,8132,Delta Air Lines,MKE,SFO
DL526,1693884188,1693884824,636,9301,Delta Air Lines,SFO,LAX
DL526,1693900105,1693901251,1146,9526,Delta Air Lines,LAX,SFO
DL526,1693919244,1693924446,5202,12604,Delta Air Lines,SFO,ORD
DL526,1693938016,1693938648,632,10276,Delta Air Lines,ORD,MKE
DL526,1693955560,1693959091,3531,10303,Delta Air Lines,MKE,ORD
DL526,1693975898,1693976354,456,17064,Delta Air Lines,ORD,MKE
DL526,1693997153,1693999241,2088,10825,Delta Air Lines,MKE,ORD
DL526,1694016416,1694017831,1415,11371,Delta Air Lines,ORD,MKE
DL526,1694037572,1694041131,3559,18468,Delta Air Lines,MKE,ORD
DL526,1694063333,1694064853,1520,10124,Delta Air Lines,ORD,MKE
DL526,1694075446,1694077123,1677,16778,Delta Air Lines,MKE,SFO
DL526,1694094707,1694105251,10544,4189,Delta Air Lines,SFO,ORD
DL526,1694116052,1694116597,545,8118,Delta Air Lines,ORD,MKE
DL526,1694129220,1694129539,319,15371,Delta Air Lines,MKE,LAX
DL526,1694151358,1694160875,9517,15340,Delta Air Lines,LAX,ORD
DL526,1694183967,1694184358,391,12791,Delta Air Lines,ORD,MKE
DL526,1694197566,1694197947,381,3948,Delta Air Lines,MKE,SFO
DL526,1694212295,1694212479,184,5952,Delta Air Lines,SFO,LAX
DL526,1694220586,1694227382,6796,13036,Delta Air Lines,LAX,ORD
DL526,1694245263,1694246003,740,19372,Delta Air Lines,ORD,MKE
DL526,1694268880,1694279240,10360,3602,Delta Air Lines,MKE,ORD
DL526,1694290814,1694291032,218,13272,Delta Air Lines,ORD,MKE
DL526,1694310420,1694314793,4373,7448,Delta Air Lines,MKE,ORD
DL526,1694331266,1694331570,304,17920,Delta Air Lines,ORD,MKE
DL526,1694351067,1694352241,1174,18388,Delta Air Lines,MKE,SFO
DL526,1694371162,1694377122,5960,18274,Delta Air Lines,SFO,ORD
DL526,1694403089,1694403459,370,8250,Delta Air Lines,ORD,MKE
DL526,1694419605,1694421165,1560,12972,Delta Air Lines,MKE,SFO
DL526,1694437204,1694437436,232,9739,Delta Air Lines,SFO,LAX
DL526,1694457050,1694458293,1243,10114,Delta Air Lines,LAX,SFO
DL526,1694471562,1694474126,2564,19351,Delta Air Lines,SFO,ORD
DL526,1694494292,1694495882,1590,14901,Delta Air Lines,ORD,MKE
DL526,1694513016,1694513023,7,9974,Delta Air Lines,MKE,LAX
DL526,1694526706,1694527807,1101,13177,Delta Air Lines,LAX,SFO
DL526,1694543760,1694545306,1546,5469,Delta Air Lines,SFO,LAX
DL526,1694558701,1694563605,4904,5680,Delta Air Lines,LAX,ORD
DL526,1694577181,1694578200,1019,14587,Delta Air Lines,ORD,MKE
DL526,1694599183,1694600852,1669,16650,Delta Air Lines,MKE,SFO
DL526,1694618325,1694619777,1452,11033,Delta Air Lines,SFO,LAX
DL526,1694636436,1694645253,8817,11677,Delta Air Lines,LAX,ORD
DL526,1694662509,1694662530,21,12012,Delta Air Lines,ORD,MKE
DL526,1694683035,1694683349,314,9117,Delta Air Lines,MKE,SFO
DL526,1694693624,1694695205,1581,5030,Delta Air Lines,SFO,LAX
DL526,1694700889,1694702412,1523,4234,Delta Air Lines,LAX,SFO
DL526,1694716829,1694725760,8931,20553,Delta Air Lines,SFO,ORD
DL526,1694756967,1694758372,1405,13905,Delta Air Lines,ORD,MKE
DL526,1694776293,1694776574,281,10437,Delta Air Lines,MKE,SFO
DL526,1694793000,1694795324,2324,15083,Delta Air Lines,SFO,ORD
DL526,1694810551,1694810958,407,20590,Delta Air Lines,ORD,MKE
DL526,1694836945,1694837985,1040,18079,Delta Air Lines,MKE,LAX
DL526,1694863368,1694867644,4276,4471,Delta Air Lines,LAX,ORD
DL526,1694877064,1694878520,1456,9177,Delta Air Lines,ORD,MKE
DL526,1694896089,1694897608,1519,5634,Delta Air Lines,MKE,LAX
DL526,1694904022,1694905581,1559,20674,Delta Air Lines,LAX,SFO
DL526,1694936744,1694942739,5995,14994,Delta Air Lines,SFO,ORD
DL526,1694962326,1694963357,1031,6040,Delta Air Lines,ORD,MKE
DL526,1694973088,1694974586,1498,13960,Delta Air Lines,MKE,LAX
DL526,1694997623,1694998509,886,9358,Delta Air Lines,LAX,SFO
DL526,1695015998,1695017111,1113,8291,Delta Air Lines,SFO,LAX
DL526,1695029280,1695037693,8413,18616,Delta Air Lines,LAX,ORD
DL526,1695065431,1695067031,1600,21228,Delta Air Lines,ORD,MKE
DL526,1695093222,1695094959,1737,15923,Delta Air Lines,MKE,LAX
DL526,1695121261,1695121373,112,13072,Delta Air Lines,LAX,SFO
DL526,1695142069,1695144763,2694,7833,Delta Air Lines,SFO,ORD
DL526,1695158105,1695159069,964,18647,Delta Air Lines,ORD,MKE
DL526,1695180984,1695188409,7425,21371,Delta Air Lines,MKE,ORD
DL526,1695213446,1695214065,619,20635,Delta Air Lines,ORD,MKE
DL526,1695236831,1695240645,3814,10609,Delta Air Lines,MKE,ORD
DL526,1695258967,1695260510,1543,7257,Delta Air Lines,ORD,MKE
DL526,1695269752,1695270099,347,19328,Delta Air Lines,MKE,LAX
DL526,1695298767,1695302909,4142,21309,Delta Air Lines,LAX,ORD
DL526,1695325303,1695326681,1378,18499,Delta Air Lines,ORD,MKE
DL526,1695348098,1695348491,393,17881,Delta Air Lines,MKE,SFO
DL526,1695371190,1695377195,6005,20755,Delta Air Lines,SFO,ORD
DL526,1695400533,1695401190,657,11901,Delta Air Lines,ORD,MKE
DL526,1695415521,1695415782,261,13956,Delta Air Lines,MKE,LAX
DL526,1695431047,1695432566,1519,19555,Delta Air Lines,LAX,SFO
DL526,1695461402,1695464609,3207,11309,Delta Air Lines,SFO,ORD
DL526,1695482563,1695483757,1194,5099,Delta Air Lines,ORD,MKE
DL526,1695490051,1695490560,509,9918,Delta Air Lines,MKE,SFO
DL526,1695509165,1695519509,10344,19424,Delta Air Lines,SFO,ORD
DL526,1695545165,1695546561,1396,5914,Delta Air Lines,ORD,MKE
DL526,1695559651,1695561447,1796,16607,Delta Air Lines,MKE,SFO
DL526,1695582490,1695590576,8086,12845,Delta Air Lines,SFO,ORD
DL526,1695612519,1695612815,296,4299,Delta Air Lines,ORD,MKE
DL526,1695617941,1695619233,1292,5514,Delta Air Lines,MKE,LAX
DL526,1695627870,1695629957,2087,4729,Delta Air Lines,LAX,ORD
DL526,1695645176,1695646096,920,10889,Delta Air Lines,ORD,MKE
DL526,1695662511,1695666702,4191,4664,Delta Air Lines,MKE,ORD
DL526,1695676237,1695677318,1081,8184,Delta Air Lines,ORD,MKE
DL526,1695693281,1695695044,1763,10388,Delta Air Lines,MKE,SFO
DL526,1695715931,1695716509,578,19211,Delta Air Lines,SFO,LAX
DL526,1695745846,1695751504,5658,11338,Delta Air Lines,LAX,ORD
DL526,1695764347,1695765659,1312,11097,Delta Air Lines,ORD,MKE
DL526,1695785775,1695791783,6008,17000,Delta Air Lines,MKE,ORD
DL526,1695817831,1695818948,1117,12086,Delta Air Lines,ORD,MKE
DL526,1695838201,1695838859,658,14436,Delta Air Lines,MKE,LAX
DL526,1695857678,1695863623,5945,5936,Delta Air Lines,LAX,ORD
DL526,1695875108,1695875807,699,7059,Delta Air Lines,ORD,MKE
DL526,1695883292,1695891157,7865,19124,Delta Air Lines,MKE,ORD
DL526,1695919486,1695920147,661,12167,Delta Air Lines,ORD,MKE
DL526,1695941675,1695942936,1261,18158,Delta Air Lines,MKE,SFO
DL526,1695967232,1695968320,1088,17423,Delta Air Lines,SFO,LAX
DL526,1695993360,1695993804,444,11049,Delta Air Lines,LAX,SFO
DL526,1696008132,1696014610,6478,5603,Delta Air Lines,SFO,ORD
DL526,1696025646,1696026975,1329,13732,Delta Air Lines,ORD,MKE
DL526,1696042390,1696042938,548,19935,Delta Air Lines,MKE,SFO
DL526,1696063260,1696073002,9742,8054,Delta Air Lines,SFO,ORD
DL526,1696086138,1696086756,618,8762,Delta Air Lines,ORD,MKE
DL526,1696104402,1696105663,1261,10704,Delta Air Lines,MKE,LAX
DL526,1696122882,1696124498,1616,12358,Delta Air Lines,LAX,SFO
DL526,1696142947,1696150411,7464,5593,Delta Air Lines,SFO,ORD
DL526,1696158069,1696159277,1208,15919,Delta Air Lines,ORD,MKE
DL526,1696175837,1696176854,1017,16869,Delta Air Lines,MKE,LAX
DL526,1696201706,1696206741,5035,15581,Delta Air Lines,LAX,ORD
DL526,1696227299,1696228045,746,5688,Delta Air Lines,ORD,MKE
DL526,1696243737,1696245922,2185,4578,Delta Air Lines,MKE,ORD
DL526,1696259366,1696260360,994,5594,Delta Air Lines,ORD,MKE
DL526,1696267950,1696278437,10487,14826,Delta Air Lines,MKE,ORD
DL526,1696296447,1696297021,574,6792,Delta Air Lines,ORD,MKE
DL526,1696306257,1696306811,554,12747,Delta Air Lines,MKE,SFO
DL526,1696324326,1696332378,8052,3927,Delta Air Lines,SFO,ORD
DL526,1696337812,1696339080,1268,14163,Delta Air Lines,ORD,MKE
DL526,1696356439,1696363946,7507,7862,Delta Air Lines,MKE,ORD
DL526,1696374187,1696374457,270,21533,Delta Air Lines,ORD,MKE
DL526,1696404552,1696413129,8577,14354,Delta Air Lines,MKE,ORD
DL526,1696437080,1696438065,985,15869,Delta Air Lines,ORD,MKE
DL526,1696462927,1696463040,113,8696,Delta Air Lines,MKE,SFO
DL526,1696475278,1696483700,8422,20384,Delta Air Lines,SFO,ORD
DL526,1696514111,1696515194,1083,18911,Delta Air Lines,ORD,MKE
DL526,1696543702,1696544093,391,4929,Delta Air Lines,MKE,LAX
DL526,1696551669,1696559341,7672,18306,Delta Air Lines,LAX,ORD
DL526,1696584843,1696586483,1640,5289,Delta Air Lines,ORD,MKE
DL526,1696592271,1696598023,5752,13003,Delta Air Lines,MKE,ORD
DL526,1696615083,1696615563,480,11377,Delta Air Lines,ORD,MKE
DL526,1696630227,1696635442,5215,10509,Delta Air Lines,MKE,ORD
DL526,1696647059,1696647732,673,12027,Delta Air Lines,ORD,MKE
DL526,1696661035,1696661237,202,17682,Delta Air Lines,MKE,SFO
DL526,1696685589,1696694507,8918,5545,Delta Air Lines,SFO,ORD
DL526,1696703789,1696705017,1228,14965,Delta Air Lines,ORD,MKE
DL526,1696724978,1696725504,526,18145,Delta Air Lines,MKE,LAX
DL526,1696743807,1696753969,10162,18770,Delta Air Lines,LAX,ORD
DL526,1696776404,1696776691,287,3947,Delta Air Lines,ORD,MKE
DL526,1696782533,1696788643,6110,15436,Delta Air Lines,MKE,ORD
DL526,1696814478,1696816078,1600,20754,Delta Air Lines,ORD,MKE
DL526,1696846951,1696848558,1607,19698,Delta Air Lines,MKE,SFO
DL526,1696878159,1696888007,9848,16266,Delta Air Lines,SFO,ORD
DL526,1696909853,1696911612,1759,13944,Delta Air Lines,ORD,MKE
DL526,1696927203,1696927696,493,17137,Delta Air Lines,MKE,LAX
DL526,1696946296,1696951919,5623,5137,Delta Air Lines,LAX,ORD
DL526,1696963229,1696963552,323,17313,Delta Air Lines,ORD,MKE
DL526,1696984446,1696984778,332,7540,Delta Air Lines,MKE,LAX
DL526,1696994307,1696995383,1076,15954,Delta Air Lines,LAX,SFO
DL526,1697014346,1697015041,695,20940,Delta Air Lines,SFO,LAX
DL526,1697039781,1697047352,7571,3783,Delta Air Lines,LAX,ORD
DL526,1697051189,1697052313,1124,6990,Delta Air Lines,ORD,MKE
DL526,1697069785,1697071334,1549,21103,Delta Air Lines,MKE,SFO
DL526,1697099533,1697100729,1196,7936,Delta Air Lines,SFO,LAX
DL526,1697114199,1697114328,129,8822,Delta Air Lines,LAX,SFO
DL526,1697123315,1697123864,549,11491,Delta Air Lines,SFO,LAX
DL526,1697143705,1697151495,7790,4017,Delta Air Lines,LAX,ORD
DL526,1697160060,1697160890,830,6893,Delta Air Lines,ORD,MKE
DL526,1697169097,1697173612,4515,5392,Delta Air Lines,MKE,ORD
DL526,1697187458,1697188029,571,9329,Delta Air Lines,ORD,MKE
DL526,1697201721,1697203082,1361,5384,Delta Air Lines,MKE,LAX
DL526,1697216377,1697221662,5285,15102,Delta Air Lines,LAX,ORD
DL526,1697238930,1697240055,1125,20945,Delta Air Lines,ORD,MKE
DL526,1697266809,1697267253,444,17985,Delta Air Lines,MKE,LAX
DL526,1697295487,1697298696,3209,18374,Delta Air Lines,LAX,ORD
DL526,1697323353,1697324772,1419,4334,Delta Air Lines,ORD,MKE
DL526,1697338229,1697339646,1417,12177,Delta Air Lines,MKE,SFO
DL526,1697356514,1697357204,690,14965,Delta Air Lines,SFO,LAX
DL526,1697375766,1697375784,18,11998,Delta Air Lines,LAX,SFO
DL526,1697394926,1697405141,10215,14514,Delta Air Lines,SFO,ORD
DL526,1697424919,1697425519,600,5780,Delta Air Lines,ORD,MKE
DL526,1697431861,1697441319,9458,6802,Delta Air Lines,MKE,ORD
DL526,1697458644,1697459458,814,18495,Delta Air Lines,ORD,MKE
DL526,1697487650,1697488771,1121,12634,Delta Air Lines,MKE,LAX
DL526,1697504742,1697506143,1401,18549,Delta Air Lines,LAX,SFO
DL526,1697531920,1697532624,704,4122,Delta Air Lines,SFO,LAX
DL526,1697545952,1697546268,316,18919,Delta Air Lines,LAX,SFO
DL526,1697570902,1697572209,1307,16245,Delta Air Lines,SFO,LAX
DL526,1697591305,1697593061,1756,10855,Delta Air Lines,LAX,SFO
DL526,1697608279,1697610010,1731,16210,Delta Air Lines,SFO,LAX
DL526,1697636916,1697640228,3312,16673,Delta Air Lines,LAX,ORD
DL526,1697657243,1697657950,707,10553,Delta Air Lines,ORD,MKE
DL526,1697672760,1697673259,499,9019,Delta Air Lines,MKE,LAX
DL526,1697690662,1697693203,2541,11314,Delta Air Lines,LAX,ORD
DL526,1697705746,1697706772,1026,14622,Delta Air Lines,ORD,MKE
DL526,1697732067,1697739276,7209,14939,Delta Air Lines,MKE,ORD
DL526,1697758580,1697759886,1306,13569,Delta Air Lines,ORD,MKE
DL526,1697779209,1697785992,6783,14072,Delta Air Lines,MKE,ORD
DL526,1697801582,1697801638,56,10557,Delta Air Lines,ORD,MKE
DL526,1697813548,1697815013,1465,12117,Delta Air Lines,MKE,SFO
DL526,1697835470,1697842961,7491,7336,Delta Air Lines,SFO,ORD
DL526,1697853996,1697854479,483,7013,Delta Air Lines,ORD,MKE
DL526,1697871787,1697871848,61,19390,Delta Air Lines,MKE,LAX
DL526,1697898795,1697900501,1706,10755,Delta Air Lines,LAX,SFO
DL526,1697912439,1697922695,10256,8440,Delta Air Lines,SFO,ORD
DL526,1697940424,1697941474,1050,8639,Delta Air Lines,ORD,MKE
DL526,1697950368,1697951876,1508,6750,Delta Air Lines,MKE,LAX
DL526,1697966252,1697966482,230,13353,Delta Air Lines,LAX,SFO
DL526,1697983887,1697985540,1653,17768,Delta Air Lines,SFO,LAX
DL526,1698012620,1698013130,510,10389,Delta Air Lines,LAX,SFO
DL526,1698025101,1698026339,1238,5461,Delta Air Lines,SFO,LAX
DL526,1698037157,1698038040,883,12059,Delta Air Lines,LAX,SFO
DL526,1698053730,1698054455,725,7483,Delta Air Lines,SFO,LAX
DL526,1698061939,1698063865,1926,14884,Delta Air Lines,LAX,ORD
DL526,1698087128,1698088083,955,9110,Delta Air Lines,ORD,MKE
DL526,1698103935,1698108208,4273,10215,Delta Air Lines,MKE,ORD
DL526,1698120915,1698122689,1774,19399,Delta Air Lines,ORD,MKE
DL526,1698145341,1698153498,8157,20037,Delta Air Lines,MKE,ORD
DL526,1698182558,1698184103,1545,17940,Delta Air Lines,ORD,MKE
DL526,1698208968,1698213906,4938,17116,Delta Air Lines,MKE,ORD
DL526,1698238782,1698239993,1211,7888,Delta Air Lines,ORD,MKE
DL526,1698253827,1698255022,1195,11330,Delta Air Lines,MKE,SFO
DL526,1698273961,1698282401,8440,6229,Delta Air Lines,SFO,ORD
DL526,1698296829,1698297468,639,18981,Delta Air Lines,ORD,MKE
DL526,1698320835,1698321997,1162,21080,Delta Air Lines,MKE,SFO
DL526,1698351683,1698353454,1771,4552,Delta Air Lines,SFO,LAX
DL526,1698359715,1698364797,5082,14730,Delta Air Lines,LAX,ORD
DL526,1698388886,1698389645,759,6275,Delta Air Lines,ORD,MKE
DL526,1698400792,1698409289,8497,18586,Delta Air Lines,MKE,ORD
DL526,1698431714,1698432800,1086,5513,Delta Air Lines,ORD,MKE
DL526,1698442236,1698442597,361,15974,Delta Air Lines,MKE,SFO
DL526,1698460625,1698464666,4041,15210,Delta Air Lines,SFO,ORD
DL526,1698481488,1698481928,440,9624,Delta Air Lines,ORD,MKE
UA388,1682959659,1682970293,10634,17546,United Airlines,SFO,LAX
UA388,1682998306,1683003610,5304,16836,United Airlines,LAX,ORD
UA388,1683030584,1683041365,10781,10666,United Airlines,ORD,MKE
UA388,1683059527,1683067255,7728,7804,United Airlines,MKE,ORD
UA388,1683077870,1683088305,10435,12570,United Airlines,ORD,MKE
UA388,1683108738,1683116767,8029,20466,United Airlines,MKE,SFO
UA388,1683137403,1683143098,5695,19496,United Airlines,SFO,LAX
UA388,1683163964,1683169014,5050,14893,United Airlines,LAX,SFO
UA388,1683192245,1683201878,9633,20401,United Airlines,SFO,LAX
UA388,1683231957,1683237969,6012,12294,United Airlines,LAX,ORD
UA388,1683253266,1683263612,10346,6602,United Airlines,ORD,MKE
UA388,1683275303,1683283400,8097,12984,United Airlines,MKE,LAX
UA388,1683299810,1683306289,6479,13800,United Airlines,LAX,SFO
UA388,1683330032,1683337320,7288,16129,United Airlines,SFO,ORD
UA388,1683363192,1683368839,5647,21445,United Airlines,ORD,MKE
UA388,1683400593,1683408168,7575,18536,United Airlines,MKE,LAX
UA388,1683434003,1683436963,2960,7446,United Airlines,LAX,ORD
UA388,1683450504,1683455411,4907,9973,United Airlines,ORD,MKE
UA388,1683468669,1683477907,9238,8872,United Airlines,MKE,LAX
UA388,1683494511,1683502411,7900,7154,United Airlines,LAX,SFO
UA388,1683512884,1683520366,7482,19526,United Airlines,SFO,LAX
UA388,1683545679,1683552226,6547,20870,United Airlines,LAX,SFO
UA388,1683581808,1683585822,4014,12577,United Airlines,SFO,LAX
UA388,1683599664,1683608583,8919,15774,United Airlines,LAX,SFO
UA388,1683631018,1683640758,9740,17373,United Airlines,SFO,ORD
UA388,1683663869,1683670013,6144,6836,United Airlines,ORD,MKE
UA388,1683686509,1683691666,5157,16457,United Airlines,MKE,ORD
UA388,1683713234,1683720006,6772,20318,United Airlines,ORD,MKE
UA388,1683745120,1683754532,9412,4951,United Airlines,MKE,SFO
UA388,1683761389,1683764288,2899,16085,United Airlines,SFO,ORD
UA388,1683781137,1683783229,2092,19985,United Airlines,ORD,MKE
UA388,1683811831,1683816012,4181,10578,United Airlines,MKE,SFO
UA388,1683828379,1683838643,10264,17404,United Airlines,SFO,LAX
UA388,1683861600,1683871616,10016,14154,United Airlines,LAX,SFO
UA388,1683892211,1683894556,2345,4834,United Airlines,SFO,LAX
UA388,1683903680,1683909492,5812,17574,United Airlines,LAX,SFO
UA388,1683929793,1683939902,10109,15294,United Airlines,SFO,ORD
UA388,1683957538,1683967692,10154,13819,United Airlines,ORD,MKE
UA388,1683989043,1683997829,8786,11672,United Airlines,MKE,ORD
UA388,1684014490,1684017112,2622,21262,United Airlines,ORD,MKE
UA388,1684044703,1684054766,10063,13159,United Airlines,MKE,ORD
UA388,1684070305,1684078287,7982,15461,United Airlines,ORD,MKE
UA388,1684099094,1684101653,2559,10741,United Airlines,MKE,SFO
UA388,1684114552,1684122723,8171,14326,United Airlines,SFO,LAX
UA388,1684140800,1684143327,2527,3649,United Airlines,LAX,SFO
UA388,1684148236,1684156995,8759,5358,United Airlines,SFO,ORD
UA388,1684166443,1684175114,8671,6510,United Airlines,ORD,MKE
UA388,1684184166,1684194403,10237,16893,United Airlines,MKE,LAX
UA388,1684211491,1684221993,10502,15537,United Airlines,LAX,SFO
UA388,1684244855,1684253138,8283,7758,United Airlines,SFO,LAX
UA388,1684262085,1684271255,9170,16710,United Airlines,LAX,SFO
UA388,1684294006,1684304057,10051,9480,United Airlines,SFO,ORD
UA388,1684322687,1684328725,6038,15296,United Airlines,ORD,MKE
UA388,1684351592,1684357278,5686,8417,United Airlines,MKE,SFO
UA388,1684369119,1684374016,4897,5852,United Airlines,SFO,ORD
UA388,1684386252,1684395649,9397,7792,United Airlines,ORD,MKE
UA388,1684408177,1684415732,7555,6961,United Airlines,MKE,ORD
UA388,1684426192,1684436548,10356,12989,United Airlines,ORD,MKE
UA388,1684453592,1684457300,3708,11216,United Airlines,MKE,ORD
UA388,1684472489,1684479107,6618,19605,United Airlines,ORD,MKE
UA388,1684504961,1684508814,3853,8973,United Airlines,MKE,ORD
UA388,1684523643,1684531099,7456,5486,United Airlines,ORD,MKE
UA388,1684539780,1684547096,7316,11782,United Airlines,MKE,ORD
UA388,1684566163,1684571889,5726,12991,United Airlines,ORD,MKE
UA388,1684594538,1684599941,5403,13832,United Airlines,MKE,LAX
UA388,1684620769,1684626620,5851,8393,United Airlines,LAX,ORD
UA388,1684637467,1684645405,7938,5066,United Airlines,ORD,MKE
UA388,1684655024,1684662676,7652,10271,United Airlines,MKE,SFO
UA388,1684677414,1684683378,5964,6240,United Airlines,SFO,LAX
UA388,1684695100,1684699912,4812,19358,United Airlines,LAX,SFO
UA388,1684726993,1684731150,4157,19061,United Airlines,SFO,ORD
UA388,1684757544,1684766853,9309,20513,United Airlines,ORD,MKE
UA388,1684791010,1684801631,10621,8294,United Airlines,MKE,SFO
UA388,1684814138,1684818075,3937,10324,United Airlines,SFO,ORD
UA388,1684837419,1684844802,7383,11523,United Airlines,ORD,MKE
UA388,1684860079,1684864076,3997,3626,United Airlines,MKE,SFO
UA388,1684869167,1684878699,9532,5167,United Airlines,SFO,ORD
UA388,1684891400,1684896847,5447,14642,United Airlines,ORD,MKE
UA388,1684918605,1684924817,6212,18534,United Airlines,MKE,SFO
UA388,1684946529,1684952790,6261,12226,United Airlines,SFO,ORD
UA388,1684969887,1684976462,6575,9399,United Airlines,ORD,MKE
UA388,1684994271,1684997596,3325,20204,United Airlines,MKE,SFO
UA388,1685022825,1685025374,2549,20964,United Airlines,SFO,LAX
UA388,1685053750,1685062084,8334,10061,United Airlines,LAX,SFO
UA388,1685081597,1685087714,6117,19738,United Airlines,SFO,ORD
UA388,1685118097,1685124951,6854,4236,United Airlines,ORD,MKE
UA388,1685139483,1685146408,6925,12976,United Airlines,MKE,ORD
UA388,1685169635,1685179566,9931,14911,United Airlines,ORD,MKE
UA388,1685200444,1685209564,9120,13752,United Airlines,MKE,LAX
UA388,1685232426,1685242861,10435,20744,United Airlines,LAX,ORD
UA388,1685269508,1685276020,6512,17396,United Airlines,ORD,MKE
UA388,1685302108,1685311515,9407,21417,United Airlines,MKE,SFO
UA388,1685333064,1685337942,4878,12887,United Airlines,SFO,LAX
UA388,1685351235,1685360338,9103,4184,United Airlines,LAX,SFO
UA388,1685368409,1685378942,10533,8953,United Airlines,SFO,LAX
UA388,1685392828,1685397982,5154,12846,United Airlines,LAX,ORD
UA388,1685415404,1685419193,3789,14641,United Airlines,ORD,MKE
UA388,1685440546,1685444977,4431,14144,United Airlines,MKE,SFO
UA388,1685466036,1685474268,8232,11314,United Airlines,SFO,LAX
UA388,1685493384,1685496157,2773,9424,United Airlines,LAX,SFO
UA388,1685506700,1685512943,6243,20781,United Airlines,SFO,LAX
UA388,1685539092,1685546018,6926,20497,United Airlines,LAX,ORD
UA388,1685575439,1685584827,9388,14809,United Airlines,ORD,MKE
UA388,1685600257,1685603588,3331,8630,United Airlines,MKE,SFO
UA388,1685619578,1685624269,4691,8264,United Airlines,SFO,ORD
UA388,1685637148,1685640463,3315,4105,United Airlines,ORD,MKE
UA388,1685653137,1685656713,3576,5509,United Airlines,MKE,ORD
UA388,1685672661,1685680924,8263,14721,United Airlines,ORD,MKE
UA388,1685697039,1685707574,10535,15838,United Airlines,MKE,ORD
UA388,1685730810,1685738273,7463,9104,United Airlines,ORD,MKE
UA388,1685751030,1685757813,6783,12548,United Airlines,MKE,ORD
UA388,1685771678,1685776389,4711,5899,United Airlines,ORD,MKE
UA388,1685786248,1685789413,3165,8447,United Airlines,MKE,SFO
UA388,1685805764,1685807956,2192,21295,United Airlines,SFO,LAX
UA388,1685835510,1685845989,10479,20049,United Airlines,LAX,ORD
UA388,1685876119,1685884550,8431,17376,United Airlines,ORD,MKE
UA388,1685902224,1685908874,6650,10155,United Airlines,MKE,ORD
UA388,1685929244,1685932558,3314,3771,United Airlines,ORD,MKE
UA388,1685941034,1685944586,3552,17846,United Airlines,MKE,SFO
UA388,1685969693,1685979878,10185,8085,United Airlines,SFO,LAX
UA388,1685998182,1686000916,2734,12967,United Airlines,LAX,ORD
UA388,1686015076,1686022209,7133,21574,United Airlines,ORD,MKE
UA388,1686045788,1686052079,6291,14396,United Airlines,MKE,SFO
UA388,1686074051,1686080095,6044,13329,United Airlines,SFO,ORD
UA388,1686098627,1686108511,9884,13016,United Airlines,ORD,MKE
UA388,1686126992,1686135916,8924,11885,United Airlines,MKE,LAX
UA388,1686153568,1686162002,8434,20132,United Airlines,LAX,SFO
UA388,1686189010,1686192622,3612,10496,United Airlines,SFO,LAX
UA388,1686211015,1686214931,3916,12323,United Airlines,LAX,SFO
UA388,1686230208,1686239188,8980,21593,United Airlines,SFO,LAX
UA388,1686270829,1686277049,6220,9839,United Airlines,LAX,SFO
UA388,1686293727,1686303896,10169,4463,United Airlines,SFO,LAX
UA388,1686314492,1686321926,7434,16178,United Airlines,LAX,SFO
UA388,1686338849,1686347145,8296,16449,United Airlines,SFO,ORD
UA388,1686367343,1686372960,5617,8842,United Airlines,ORD,MKE
UA388,1686385489,1686387787,2298,12554,United Airlines,MKE,ORD
UA388,1686404794,1686408652,3858,4840,United Airlines,ORD,MKE
UA388,1686421403,1686426415,5012,4136,United Airlines,MKE,LAX
UA388,1686432473,1686436015,3542,10495,United Airlines,LAX,SFO
UA388,1686454720,1686465072,10352,10327,United Airlines,SFO,ORD
UA388,1686485710,1686489903,4193,10113,United Airlines,ORD,MKE
UA388,1686509626,1686514923,5297,18201,United Airlines,MKE,SFO
UA388,1686534773,1686538607,3834,9754,United Airlines,SFO,LAX
UA388,1686558366,1686563020,4654,20954,United Airlines,LAX,ORD
UA388,1686588001,1686598084,10083,15058,United Airlines,ORD,MKE
UA388,1686617119,1686625737,8618,7037,United Airlines,MKE,LAX
UA388,1686633975,1686638666,4691,6516,United Airlines,LAX,ORD
UA388,1686653767,1686664233,10466,7449,United Airlines,ORD,MKE
UA388,1686671975,1686679471,7496,12847,United Airlines,MKE,ORD
UA388,1686693588,1686704330,10742,17598,United Airlines,ORD,MKE
UA388,1686723491,1686729291,5800,10487,United Airlines,MKE,LAX
UA388,1686744423,1686753978,9555,20227,United Airlines,LAX,ORD
UA388,1686775243,1686785266,10023,20568,United Airlines,ORD,MKE
UA388,1686806156,1686814961,8805,13722,United Airlines,MKE,LAX
UA388,1686832493,1686842802,10309,20281,United Airlines,LAX,SFO
UA388,1686864119,1686868120,4001,9542,United Airlines,SFO,LAX
UA388,1686879593,1686882043,2450,13637,United Airlines,LAX,ORD
UA388,1686902946,1686911297,8351,8083,United Airlines,ORD,MKE
UA388,1686923629,1686932049,8420,14285,United Airlines,MKE,LAX
UA388,1686955892,1686963129,7237,17088,United Airlines,LAX,ORD
UA388,1686982593,1686989722,7129,12602,United Airlines,ORD,MKE
UA388,1687003012,1687010646,7634,11635,United Airlines,MKE,SFO
UA388,1687025970,1687031038,5068,17194,United Airlines,SFO,LAX
UA388,1687054629,1687062352,7723,4891,United Airlines,LAX,ORD
UA388,1687077484,1687085657,8173,4981,United Airlines,ORD,MKE
UA388,1687099881,1687109055,9174,18881,United Airlines,MKE,SFO
UA388,1687133172,1687137440,4268,21135,United Airlines,SFO,ORD
UA388,1687168631,1687173315,4684,16895,United Airlines,ORD,MKE
UA388,1687200992,1687206704,5712,18366,United Airlines,MKE,SFO
UA388,1687227498,1687230065,2567,13404,United Airlines,SFO,ORD
UA388,1687253877,1687258632,4755,19912,United Airlines,ORD,MKE
UA388,1687287261,1687296492,9231,9224,United Airlines,MKE,ORD
UA388,1687312896,1687320371,7475,7334,United Airlines,ORD,MKE
UA388,1687331052,1687334997,3945,20452,United Airlines,MKE,ORD
UA388,1687359382,1687369724,10342,17271,United Airlines,ORD,MKE
UA388,1687390381,1687395016,4635,21599,United Airlines,MKE,SFO
UA388,1687422578,1687429690,7112,17205,United Airlines,SFO,ORD
UA388,1687456500,1687461490,4990,20677,United Airlines,ORD,MKE
UA388,1687491884,1687500261,8377,12852,United Airlines,MKE,LAX
UA388,1687515741,1687519161,3420,7243,United Airlines,LAX,SFO
UA388,1687536946,1687547013,10067,4633,United Airlines,SFO,LAX
UA388,1687553354,1687560860,7506,9021,United Airlines,LAX,ORD
UA388,1687576299,1687580518,4219,4899,United Airlines,ORD,MKE
UA388,1687592406,1687597253,4847,17749,United Airlines,MKE,ORD
UA388,1687620435,1687626117,5682,13141,United Airlines,ORD,MKE
UA388,1687639435,1687649586,10151,17937,United Airlines,MKE,ORD
UA388,1687672955,1687676067,3112,16057,United Airlines,ORD,MKE
UA388,1687694472,1687699026,4554,7114,United Airlines,MKE,LAX
UA388,1687711580,1687716269,4689,18944,United Airlines,LAX,SFO
UA388,1687739182,1687742740,3558,13783,United Airlines,SFO,LAX
UA388,1687766992,1687775475,8483,14625,United Airlines,LAX,ORD
UA388,1687795680,1687801013,5333,15842,United Airlines,ORD,MKE
UA388,1687822331,1687825370,3039,12942,United Airlines,MKE,ORD
UA388,1687839531,1687845408,5877,3773,United Airlines,ORD,MKE
UA388,1687856403,1687860408,4005,20254,United Airlines,MKE,ORD
UA388,1687889330,1687897506,8176,5614,United Airlines,ORD,MKE
UA388,1687904540,1687909797,5257,14826,United Airlines,MKE,ORD
UA388,1687925954,1687935852,9898,14514,United Airlines,ORD,MKE
UA388,1687952377,1687955322,2945,15096,United Airlines,MKE,SFO
UA388,1687978365,1687988612,10247,4798,United Airlines,SFO,ORD
UA388,1688003233,1688005322,2089,12655,United Airlines,ORD,MKE
UA388,1688025148,1688029278,4130,17835,United Airlines,MKE,ORD
UA388,1688057670,1688062845,5175,19530,United Airlines,ORD,MKE
UA388,1688092794,1688102047,9253,8096,United Airlines,MKE,SFO
UA388,1688120145,1688126684,6539,16913,United Airlines,SFO,LAX
UA388,1688144163,1688148803,4640,16417,United Airlines,LAX,SFO
UA388,1688172899,1688183142,10243,10408,United Airlines,SFO,LAX
UA388,1688197426,1688200657,3231,15332,United Airlines,LAX,ORD
UA388,1688225853,1688230347,4494,15734,United Airlines,ORD,MKE
UA388,1688255587,1688263640,8053,20493,United Airlines,MKE,SFO
UA388,1688287406,1688291271,3865,19284,United Airlines,SFO,LAX
UA388,1688316902,1688321688,4786,4493,United Airlines,LAX,SFO
UA388,1688329460,1688338896,9436,4811,United Airlines,SFO,LAX
UA388,1688349471,1688355247,5776,18441,United Airlines,LAX,ORD
UA388,1688382256,1688389626,7370,15349,United Airlines,ORD,MKE
UA388,1688405200,1688410879,5679,3908,United Airlines,MKE,LAX
UA388,1688424193,1688428321,4128,17363,United Airlines,LAX,SFO
UA388,1688451885,1688461065,9180,10364,United Airlines,SFO,LAX
UA388,1688473357,1688482743,9386,11448,United Airlines,LAX,ORD
UA388,1688494428,1688502356,7928,17792,United Airlines,ORD,MKE
UA388,1688527959,1688529993,2034,19867,United Airlines,MKE,ORD
UA388,1688550535,1688560554,10019,19109,United Airlines,ORD,MKE
UA388,1688588331,1688594237,5906,18732,United Airlines,MKE,ORD
UA388,1688616762,1688619103,2341,10758,United Airlines,ORD,MKE
UA388,1688633133,1688635872,2739,10086,United Airlines,MKE,LAX
UA388,1688651060,1688656723,5663,20550,United Airlines,LAX,ORD
UA388,1688687746,1688690973,3227,18956,United Airlines,ORD,MKE
UA388,1688710726,1688718500,7774,8890,United Airlines,MKE,SFO
UA388,1688737933,1688742352,4419,21449,United Airlines,SFO,LAX
UA388,1688772857,1688775419,2562,6349,United Airlines,LAX,SFO
UA388,1688783808,1688787034,3226,14719,United Airlines,SFO,ORD
UA388,1688804310,1688808736,4426,13613,United Airlines,ORD,MKE
UA388,1688827697,1688831130,3433,6307,United Airlines,MKE,SFO
UA388,1688837497,1688847872,10375,21397,United Airlines,SFO,LAX
UA388,1688877478,1688888109,10631,10628,United Airlines,LAX,SFO
UA388,1688905251,1688913959,8708,12943,United Airlines,SFO,LAX
UA388,1688931819,1688937245,5426,18554,United Airlines,LAX,SFO
UA388,1688958935,1688965838,6903,8033,United Airlines,SFO,LAX
UA388,1688983186,1688989227,6041,11738,United Airlines,LAX,SFO
UA388,1689003198,1689009390,6192,11239,United Airlines,SFO,LAX
UA388,1689029835,1689035324,5489,13174,United Airlines,LAX,ORD
UA388,1689058932,1689061043,2111,7041,United Airlines,ORD,MKE
UA388,1689075988,1689081912,5924,14233,United Airlines,MKE,LAX
UA388,1689100422,1689102860,2438,16239,United Airlines,LAX,ORD
UA388,1689129809,1689138584,8775,5853,United Airlines,ORD,MKE
UA388,1689154943,1689165058,10115,19557,United Airlines,MKE,LAX
UA388,1689186660,1689193609,6949,15037,United Airlines,LAX,ORD
UA388,1689208650,1689213432,4782,20012,United Airlines,ORD,MKE
UA388,1689237302,1689240890,3588,17282,United Airlines,MKE,SFO
UA388,1689266473,1689273221,6748,17475,United Airlines,SFO,LAX
UA388,1689294158,1689301854,7696,10361,United Airlines,LAX,SFO
UA388,1689322489,1689330879,8390,16123,United Airlines,SFO,ORD
UA388,1689352296,1689360238,7942,6819,United Airlines,ORD,MKE
UA388,1689370575,1689375109,4534,13495,United Airlines,MKE,ORD
UA388,1689395298,1689397379,2081,20227,United Airlines,ORD,MKE
UA388,1689426663,1689436585,9922,15259,United Airlines,MKE,LAX
UA388,1689456689,1689465298,8609,7936,United Airlines,LAX,SFO
UA388,1689473741,1689482477,8736,20189,United Airlines,SFO,ORD
UA388,1689504746,1689514955,10209,14137,United Airlines,ORD,MKE
UA388,1689529200,1689536477,7277,21012,United Airlines,MKE,SFO
UA388,1689564171,1689568015,3844,6513,United Airlines,SFO,ORD
UA388,1689576834,1689580233,3399,7156,United Airlines,ORD,MKE
UA388,1689587448,1689594524,7076,19258,United Airlines,MKE,SFO
UA388,1689621580,1689625062,3482,13109,United Airlines,SFO,LAX
UA388,1689639915,1689646792,6877,11577,United Airlines,LAX,SFO
UA388,1689664564,1689669068,4504,16879,United Airlines,SFO,LAX
UA388,1689690128,1689693765,3637,9784,United Airlines,LAX,ORD
UA388,1689703641,1689707656,4015,8723,United Airlines,ORD,MKE
UA388,1689719631,1689728948,9317,10782,United Airlines,MKE,SFO
UA388,1689741471,1689750779,9308,8614,United Airlines,SFO,LAX
UA388,1689767168,1689769932,2764,13658,United Airlines,LAX,SFO
UA388,1689789411,1689800150,10739,10593,United Airlines,SFO,LAX
UA388,1689815556,1689819385,3829,20791,United Airlines,LAX,SFO
UA388,1689849245,1689852678,3433,5069,United Airlines,SFO,LAX
UA388,1689860668,1689864912,4244,8278,United Airlines,LAX,ORD
UA388,1689883413,1689893456,10043,16334,United Airlines,ORD,MKE
UA388,1689912224,1689917948,5724,12914,United Airlines,MKE,ORD
UA388,1689935615,1689941141,5526,14087,United Airlines,ORD,MKE
UA388,1689962190,1689968584,6394,20571,United Airlines,MKE,SFO
UA388,1689993045,1690001640,8595,12098,United Airlines,SFO,ORD
UA388,1690022521,1690031328,8807,5660,United Airlines,ORD,MKE
UA388,1690046807,1690053838,7031,17331,United Airlines,MKE,SFO
UA388,1690073611,1690078642,5031,8218,United Airlines,SFO,LAX
UA388,1690089257,1690096150,6893,4115,United Airlines,LAX,ORD
UA388,1690111053,1690120636,9583,15602,United Airlines,ORD,MKE
UA388,1690138226,1690145300,7074,6562,United Airlines,MKE,LAX
UA388,1690159467,1690163682,4215,16414,United Airlines,LAX,SFO
UA388,1690186341,1690190173,3832,8265,United Airlines,SFO,LAX
UA388,1690200836,1690203778,2942,9334,United Airlines,LAX,ORD
UA388,1690219585,1690223570,3985,5118,United Airlines,ORD,MKE
UA388,1690231065,1690234554,3489,6821,United Airlines,MKE,SFO
UA388,1690249815,1690251936,2121,8141,United Airlines,SFO,ORD
UA388,1690262586,1690265394,2808,18949,United Airlines,ORD,MKE
UA388,1690290764,1690293623,2859,13607,United Airlines,MKE,LAX
UA388,1690308843,1690317315,8472,10982,United Airlines,LAX,SFO
UA388,1690330393,1690336269,5876,17292,United Airlines,SFO,LAX
UA388,1690355552,1690364589,9037,13682,United Airlines,LAX,SFO
UA388,1690385353,1690393407,8054,15804,United Airlines,SFO,LAX
UA388,1690418363,1690423918,5555,6624,United Airlines,LAX,ORD
UA388,1690438200,1690448287,10087,4392,United Airlines,ORD,MKE
UA388,1690456372,1690462697,6325,7106,United Airlines,MKE,ORD
UA388,1690474226,1690483574,9348,15850,United Airlines,ORD,MKE
UA388,1690504986,1690507211,2225,18586,United Airlines,MKE,ORD
UA388,1690534306,1690538721,4415,15470,United Airlines,ORD,MKE
UA388,1690557812,1690567757,9945,16726,United Airlines,MKE,LAX
UA388,1690585201,1690587521,2320,4230,United Airlines,LAX,SFO
UA388,1690594627,1690597688,3061,17950,United Airlines,SFO,LAX
UA388,1690618917,1690623133,4216,21072,United Airlines,LAX,SFO
UA388,1690646814,1690651184,4370,20505,United Airlines,SFO,ORD
UA388,1690678608,1690689305,10697,16585,United Airlines,ORD,MKE
UA388,1690712059,1690715985,3926,5772,United Airlines,MKE,LAX
UA388,1690732529,1690738797,6268,15910,United Airlines,LAX,SFO
UA388,1690761669,1690769105,7436,11681,United Airlines,SFO,LAX
UA388,1690781277,1690788790,7513,7792,United Airlines,LAX,ORD
UA388,1690804142,1690810119,5977,4917,United Airlines,ORD,MKE
UA388,1690815178,1690818656,3478,12723,United Airlines,MKE,ORD
UA388,1690831432,1690833361,1929,18757,United Airlines,ORD,MKE
UA388,1690854261,1690863487,9226,18666,United Airlines,MKE,LAX
UA388,1690890004,1690895324,5320,6833,United Airlines,LAX,SFO
UA388,1690911133,1690919813,8680,16579,United Airlines,SFO,ORD
UA388,1690945580,1690950510,4930,15127,United Airlines,ORD,MKE
UA388,1690971278,1690973709,2431,15059,United Airlines,MKE,ORD
UA388,1690999285,1691008709,9424,19261,United Airlines,ORD,MKE
UA388,1691031577,1691039857,8280,18054,United Airlines,MKE,SFO
UA388,1691059845,1691069811,9966,11566,United Airlines,SFO,ORD
UA388,1691091051,1691100516,9465,16391,United Airlines,ORD,MKE
UA388,1691120847,1691123910,3063,17798,United Airlines,MKE,ORD
UA388,1691152393,1691157514,5121,15633,United Airlines,ORD,MKE
UA388,1691179069,1691187251,8182,7447,United Airlines,MKE,SFO
UA388,1691202669,1691206862,4193,4903,United Airlines,SFO,ORD
UA388,1691212029,1691214898,2869,13086,United Airlines,ORD,MKE
UA388,1691231153,1691236991,5838,13036,United Airlines,MKE,LAX
UA388,1691254211,1691261358,7147,9451,United Airlines,LAX,ORD
UA388,1691278897,1691287738,8841,8708,United Airlines,ORD,MKE
UA388,1691301227,1691307101,5874,8708,United Airlines,MKE,SFO
UA388,1691316152,1691323381,7229,5721,United Airlines,SFO,ORD
UA388,1691336288,1691339886,3598,5911,United Airlines,ORD,MKE
UA388,1691354675,1691360686,6011,12930,United Airlines,MKE,ORD
UA388,1691379192,1691386438,7246,19632,United Airlines,ORD,MKE
UA388,1691410537,1691415797,5260,20053,United Airlines,MKE,SFO
UA388,1691436944,1691446640,9696,17442,United Airlines,SFO,LAX
UA388,1691468484,1691472368,3884,18195,United Airlines,LAX,SFO
UA388,1691493336,1691495990,2654,17759,United Airlines,SFO,LAX
UA388,1691515585,1691524065,8480,8354,United Airlines,LAX,ORD
UA388,1691540577,1691546337,5760,19533,United Airlines,ORD,MKE
UA388,1691569490,1691576673,7183,10507,United Airlines,MKE,SFO
UA388,1691590120,1691595992,5872,8988,United Airlines,SFO,ORD
UA388,1691608646,1691617324,8678,14040,United Airlines,ORD,MKE
UA388,1691639324,1691647700,8376,19676,United Airlines,MKE,SFO
UA388,1691672138,1691674945,2807,11673,United Airlines,SFO,ORD
UA388,1691688861,1691691870,3009,6156,United Airlines,ORD,MKE
UA388,1691704088,1691710591,6503,12142,United Airlines,MKE,ORD
UA388,1691730402,1691734126,3724,18950,United Airlines,ORD,MKE
UA388,1691762793,1691771934,9141,12948,United Airlines,MKE,SFO
UA388,1691785430,1691789473,4043,13401,United Airlines,SFO,ORD
UA388,1691813614,1691817086,3472,8602,United Airlines,ORD,MKE
UA388,1691834732,1691840534,5802,11822,United Airlines,MKE,ORD
UA388,1691858089,1691861592,3503,12702,United Airlines,ORD,MKE
UA388,1691878027,1691884532,6505,15151,United Airlines,MKE,ORD
UA388,1691900597,1691902704,2107,13900,United Airlines,ORD,MKE
UA388,1691923337,1691930031,6694,20788,United Airlines,MKE,SFO
UA388,1691954681,1691961342,6661,13535,United Airlines,SFO,LAX
UA388,1691983206,1691985027,1821,5632,United Airlines,LAX,ORD
UA388,1691997365,1692000861,3496,15417,United Airlines,ORD,MKE
UA388,1692026896,1692035615,8719,8458,United Airlines,MKE,SFO
UA388,1692047456,1692055582,8126,12698,United Airlines,SFO,ORD
UA388,1692070880,1692079153,8273,19461,United Airlines,ORD,MKE
UA388,1692106740,1692113611,6871,15136,United Airlines,MKE,SFO
UA388,1692131337,1692134152,2815,16093,United Airlines,SFO,ORD
UA388,1692150793,1692156717,5924,6437,United Airlines,ORD,MKE
UA388,1692164711,1692167201,2490,6057,United Airlines,MKE,ORD
UA388,1692181078,1692190592,9514,18728,United Airlines,ORD,MKE
UA388,1692214502,1692220595,6093,11959,United Airlines,MKE,LAX
UA388,1692235029,1692241437,6408,4016,United Airlines,LAX,SFO
UA388,1692248213,1692251397,3184,17484,United Airlines,SFO,LAX
UA388,1692270816,1692274212,3396,17185,United Airlines,LAX,ORD
UA388,1692298993,1692306505,7512,6481,United Airlines,ORD,MKE
UA388,1692316514,1692323299,6785,3726,United Airlines,MKE,LAX
UA388,1692331188,1692335714,4526,5364,United Airlines,LAX,ORD
UA388,1692345400,1692354417,9017,13174,United Airlines,ORD,MKE
UA388,1692368905,1692372049,3144,11850,United Airlines,MKE,ORD
UA388,1692391637,1692397723,6086,15631,United Airlines,ORD,MKE
UA388,1692419720,1692425461,5741,4425,United Airlines,MKE,ORD
UA388,1692430141,1692437096,6955,7377,United Airlines,ORD,MKE
UA388,1692447279,1692449760,2481,12578,United Airlines,MKE,ORD
UA388,1692462514,1692467574,5060,12986,United Airlines,ORD,MKE
UA388,1692482247,1692491222,8975,20931,United Airlines,MKE,ORD
UA388,1692514318,1692524177,9859,11750,United Airlines,ORD,MKE
UA388,1692537480,1692545208,7728,16996,United Airlines,MKE,SFO
UA388,1692571106,1692577810,6704,5559,United Airlines,SFO,ORD
UA388,1692589786,1692596878,7092,5639,United Airlines,ORD,MKE
UA388,1692607125,1692613960,6835,17733,United Airlines,MKE,ORD
UA388,1692637114,1692642835,5721,16958,United Airlines,ORD,MKE
UA388,1692665734,1692671667,5933,18586,United Airlines,MKE,SFO
UA388,1692699920,1692707236,7316,13624,United Airlines,SFO,LAX
UA388,1692726764,1692736100,9336,10169,United Airlines,LAX,SFO
UA388,1692752328,1692761166,8838,15963,United Airlines,SFO,ORD
UA388,1692784203,1692787374,3171,13493,United Airlines,ORD,MKE
UA388,1692801379,1692809110,7731,20647,United Airlines,MKE,ORD
UA388,1692837665,1692844389,6724,7143,United Airlines,ORD,MKE
UA388,1692855133,1692862994,7861,18497,United Airlines,MKE,SFO
UA388,1692883446,1692890839,7393,5656,United Airlines,SFO,ORD
UA388,1692906836,1692908847,2011,19198,United Airlines,ORD,MKE
UA388,1692935222,1692940782,5560,5732,United Airlines,MKE,LAX
UA388,1692953025,1692960215,7190,7881,United Airlines,LAX,SFO
UA388,1692969264,1692974876,5612,12222,United Airlines,SFO,LAX
UA388,1692996260,1692999887,3627,11937,United Airlines,LAX,ORD
UA388,1693015427,1693017727,2300,8061,United Airlines,ORD,MKE
UA388,1693033256,1693036021,2765,13574,United Airlines,MKE,LAX
UA388,1693059442,1693062070,2628,4502,United Airlines,LAX,ORD
UA388,1693069185,1693074861,5676,11103,United Airlines,ORD,MKE
UA388,1693089224,1693097212,7988,12485,United Airlines,MKE,ORD
UA388,1693117974,1693127614,9640,8246,United Airlines,ORD,MKE
UA388,1693136549,1693144456,7907,18240,United Airlines,MKE,LAX
UA388,1693168464,1693177136,8672,16334,United Airlines,LAX,SFO
UA388,1693198748,1693203931,5183,12547,United Airlines,SFO,LAX
UA388,1693225431,1693234343,8912,11913,United Airlines,LAX,ORD
UA388,1693251559,1693255578,4019,3658,United Airlines,ORD,MKE
UA388,1693259427,1693263757,4330,14544,United Airlines,MKE,LAX
UA388,1693288156,1693296665,8509,18959,United Airlines,LAX,ORD
UA388,1693323675,1693332797,9122,20325,United Airlines,ORD,MKE
UA388,1693355326,1693359507,4181,4271,United Airlines,MKE,LAX
UA388,1693368489,1693376419,7930,16890,United Airlines,LAX,ORD
UA388,1693402230,1693409439,7209,17462,United Airlines,ORD,MKE
UA388,1693434089,1693437822,3733,18617,United Airlines,MKE,SFO
UA388,1693456458,1693461931,5473,12105,United Airlines,SFO,ORD
UA388,1693476446,1693486001,9555,15021,United Airlines,ORD,MKE
UA388,1693506382,1693512307,5925,11406,United Airlines,MKE,ORD
UA388,1693527887,1693532257,4370,19377,United Airlines,ORD,MKE
UA388,1693561141,1693567317,6176,21486,United Airlines,MKE,ORD
UA388,1693592427,1693595980,3553,9174,United Airlines,ORD,MKE
UA388,1693613992,1693616537,2545,8105,United Airlines,MKE,LAX
UA388,1693631013,1693638413,7400,13370,United Airlines,LAX,ORD
UA388,1693658148,1693664235,6087,10319,United Airlines,ORD,MKE
UA388,1693679156,1693682106,2950,11399,United Airlines,MKE,LAX
UA388,1693694493,1693704635,10142,10370,United Airlines,LAX,ORD
UA388,1693723680,1693730516,6836,9787,United Airlines,ORD,MKE
UA388,1693749300,1693753533,4233,16041,United Airlines,MKE,SFO
UA388,1693771978,1693775273,3295,18631,United Airlines,SFO,ORD
UA388,1693799126,1693801674,2548,7303,United Airlines,ORD,MKE
UA388,1693813525,1693815491,1966,7480,United Airlines,MKE,SFO
UA388,1693826209,1693828113,1904,5757,United Airlines,SFO,ORD
UA388,1693834454,1693837396,2942,12548,United Airlines,ORD,MKE
UA388,1693855850,1693863590,7740,8801,United Airlines,MKE,ORD
UA388,1693877104,1693887481,10377,10999,United Airlines,ORD,MKE
UA388,1693900899,1693905835,4936,5271,United Airlines,MKE,SFO
UA388,1693919662,1693924690,5028,17255,United Airlines,SFO,LAX
UA388,1693948658,1693952643,3985,18898,United Airlines,LAX,SFO
UA388,1693971543,1693981331,9788,18274,United Airlines,SFO,LAX
UA388,1694001762,1694005514,3752,21483,United Airlines,LAX,SFO
UA388,1694027537,1694034440,6903,8475,United Airlines,SFO,LAX
UA388,1694050215,1694060639,10424,7513,United Airlines,LAX,SFO
UA388,1694078225,1694085799,7574,4028,United Airlines,SFO,LAX
UA388,1694100353,1694108479,8126,12592,United Airlines,LAX,SFO
UA388,1694129232,1694135672,6440,12136,United Airlines,SFO,ORD
UA388,1694152613,1694158164,5551,16546,United Airlines,ORD,MKE
UA388,1694182358,1694192012,9654,19057,United Airlines,MKE,LAX
UA388,1694221295,1694231067,9772,7167,United Airlines,LAX,SFO
UA388,1694243746,1694246049,2303,10523,United Airlines,SFO,ORD
UA388,1694261053,1694263454,2401,15539,United Airlines,ORD,MKE
UA388,1694287444,1694291234,3790,21391,United Airlines,MKE,ORD
UA388,1694316702,1694322944,6242,20400,United Airlines,ORD,MKE
UA388,1694344612,1694353694,9082,11873,United Airlines,MKE,SFO
UA388,1694372477,1694379605,7128,21383,United Airlines,SFO,LAX
UA388,1694410027,1694412789,2762,4770,United Airlines,LAX,ORD
UA388,1694427906,1694430906,3000,20473,United Airlines,ORD,MKE
UA388,1694452811,1694462690,9879,19504,United Airlines,MKE,SFO
UA388,1694483179,1694491375,8196,10924,United Airlines,SFO,ORD
UA388,1694504047,1694513533,9486,16481,United Airlines,ORD,MKE
UA388,1694534657,1694539236,4579,6432,United Airlines,MKE,LAX
UA388,1694555383,1694563764,8381,17611,United Airlines,LAX,SFO
UA388,1694589101,1694595616,6515,14250,United Airlines,SFO,LAX
UA388,1694618199,1694622670,4471,3944,United Airlines,LAX,SFO
UA388,1694635492,1694640100,4608,11155,United Airlines,SFO,ORD
UA388,1694658963,1694664973,6010,15173,United Airlines,ORD,MKE
UA388,1694682475,1694688402,5927,13316,United Airlines,MKE,LAX
UA388,1694702321,1694707894,5573,19854,United Airlines,LAX,SFO
UA388,1694730984,1694732787,1803,20397,United Airlines,SFO,LAX
UA388,1694753191,1694757408,4217,17036,United Airlines,LAX,SFO
UA388,1694781802,1694787708,5906,11339,United Airlines,SFO,ORD
UA388,1694805057,1694814745,9688,6960,United Airlines,ORD,MKE
UA388,1694826535,1694834527,7992,9844,United Airlines,MKE,ORD
UA388,1694849202,1694855730,6528,16307,United Airlines,ORD,MKE
UA388,1694878976,1694887159,8183,7365,United Airlines,MKE,SFO
UA388,1694899401,1694904687,5286,20077,United Airlines,SFO,ORD
UA388,1694929209,1694939451,10242,11499,United Airlines,ORD,MKE
UA388,1694952060,1694954579,2519,13167,United Airlines,MKE,ORD
UA388,1694973797,1694978719,4922,19412,United Airlines,ORD,MKE
UA388,1695006749,1695014502,7753,10388,United Airlines,MKE,SFO
UA388,1695028357,1695036240,7883,7415,United Airlines,SFO,ORD
UA388,1695051357,1695061570,10213,13184,United Airlines,ORD,MKE
UA388,1695081771,1695087328,5557,17143,United Airlines,MKE,SFO
UA388,1695106655,1695110897,4242,20653,United Airlines,SFO,LAX
UA388,1695131647,1695135152,3505,6940,United Airlines,LAX,SFO
UA388,1695148077,1695150738,2661,19571,United Airlines,SFO,LAX
UA388,1695170430,1695174143,3713,19031,United Airlines,LAX,ORD
UA388,1695200978,1695208371,7393,19197,United Airlines,ORD,MKE
UA388,1695227774,1695235268,7494,10001,United Airlines,MKE,SFO
UA388,1695250590,1695260936,10346,13214,United Airlines,SFO,LAX
UA388,1695277783,1695282081,4298,11311,United Airlines,LAX,SFO
UA388,1695300601,1695310137,9536,20821,United Airlines,SFO,LAX
UA388,1695334164,1695337484,3320,5080,United Airlines,LAX,ORD
UA388,1695348757,1695356518,7761,14737,United Airlines,ORD,MKE
UA388,1695381051,1695390307,9256,7597,United Airlines,MKE,LAX
UA388,1695401330,1695404030,2700,3984,United Airlines,LAX,SFO
UA388,1695415127,1695420411,5284,12706,United Airlines,SFO,ORD
UA388,1695443753,1695445966,2213,15070,United Airlines,ORD,MKE
UA388,1695464224,1695466611,2387,16970,United Airlines,MKE,ORD
UA388,1695483706,1695494468,10762,4841,United Airlines,ORD,MKE
UA388,1695506030,1695512014,5984,20088,United Airlines,MKE,ORD
UA388,1695533819,1695541665,7846,13447,United Airlines,ORD,MKE
UA388,1695555247,1695558701,3454,17384,United Airlines,MKE,ORD
UA388,1695585671,1695590145,4474,12804,United Airlines,ORD,MKE
UA388,1695605763,1695612013,6250,8775,United Airlines,MKE,LAX
UA388,1695628216,1695631091,2875,4327,United Airlines,LAX,SFO
UA388,1695642596,1695653315,10719,16297,United Airlines,SFO,LAX
UA388,1695675382,1695684584,9202,3698,United Airlines,LAX,ORD
UA388,1695697642,1695706128,8486,16263,United Airlines,ORD,MKE
UA388,1695725229,1695734702,9473,14204,United Airlines,MKE,LAX
UA388,1695752909,1695762884,9975,18375,United Airlines,LAX,SFO
UA388,1695784673,1695792144,7471,17433,United Airlines,SFO,LAX
UA388,1695817553,1695823807,6254,17128,United Airlines,LAX,SFO
UA388,1695843593,1695850839,7246,20518,United Airlines,SFO,LAX
UA388,1695871608,1695874003,2395,14370,United Airlines,LAX,ORD
UA388,1695893455,1695900288,6833,6236,United Airlines,ORD,MKE
UA388,1695913606,1695924223,10617,17153,United Airlines,MKE,ORD
UA388,1695944803,1695955468,10665,20788,United Airlines,ORD,MKE
UA388,1695986177,1695992433,6256,12185,United Airlines,MKE,SFO
UA388,1696012375,1696016500,4125,17623,United Airlines,SFO,LAX
UA388,1696037999,1696045960,7961,10247,United Airlines,LAX,ORD
UA388,1696062292,1696065573,3281,3899,United Airlines,ORD,MKE
UA388,1696077131,1696079612,2481,15317,United Airlines,MKE,LAX
UA388,1696096180,1696106191,10011,8301,United Airlines,LAX,SFO
UA388,1696123710,1696127243,3533,7699,United Airlines,SFO,ORD
UA388,1696139957,1696142218,2261,17928,United Airlines,ORD,MKE
UA388,1696165180,1696170864,5684,15109,United Airlines,MKE,LAX
UA388,1696186612,1696194213,7601,16229,United Airlines,LAX,SFO
UA388,1696218643,1696221895,3252,4836,United Airlines,SFO,LAX
UA388,1696234745,1696245276,10531,6604,United Airlines,LAX,ORD
UA388,1696260558,1696265054,4496,14891,United Airlines,ORD,MKE
UA388,1696289798,1696299191,9393,12233,United Airlines,MKE,SFO
UA388,1696313363,1696319754,6391,13333,United Airlines,SFO,ORD
UA388,1696338393,1696343867,5474,4896,United Airlines,ORD,MKE
UA388,1696349503,1696355150,5647,16008,United Airlines,MKE,SFO
UA388,1696375627,1696385226,9599,12224,United Airlines,SFO,ORD
UA388,1696397812,1696402719,4907,4030,United Airlines,ORD,MKE
UA388,1696407174,1696417481,10307,6295,United Airlines,MKE,ORD
UA388,1696428947,1696435080,6133,12647,United Airlines,ORD,MKE
UA388,1696457369,1696466571,9202,4880,United Airlines,MKE,LAX
UA388,1696478060,1696483313,5253,16681,United Airlines,LAX,SFO
UA388,1696508467,1696510833,2366,12288,United Airlines,SFO,LAX
UA388,1696524853,1696526855,2002,15814,United Airlines,LAX,ORD
UA388,1696542735,1696548008,5273,20561,United Airlines,ORD,MKE
UA388,1696573991,1696580604,6613,16507,United Airlines,MKE,SFO
UA388,1696607780,1696609761,1981,6896,United Airlines,SFO,LAX
UA388,1696620883,1696629036,8153,12833,United Airlines,LAX,SFO
UA388,1696647372,1696654050,6678,18079,United Airlines,SFO,ORD
UA388,1696674169,1696677379,3210,5429,United Airlines,ORD,MKE
UA388,1696690056,1696693798,3742,8242,United Airlines,MKE,ORD
UA388,1696707212,1696717043,9831,20246,United Airlines,ORD,MKE
UA388,1696742677,1696751452,8775,14014,United Airlines,MKE,SFO
UA388,1696773613,1696783860,10247,4649,United Airlines,SFO,ORD
UA388,1696790012,1696799930,9918,12331,United Airlines,ORD,MKE
UA388,1696820042,1696825930,5888,6088,United Airlines,MKE,LAX
UA388,1696835269,1696841149,5880,18922,United Airlines,LAX,ORD
UA388,1696865848,1696870434,4586,9243,United Airlines,ORD,MKE
UA388,1696888606,1696896446,7840,9815,United Airlines,MKE,LAX
UA388,1696907703,1696917101,9398,4638,United Airlines,LAX,SFO
UA388,1696931540,1696939567,8027,3949,United Airlines,SFO,ORD
UA388,1696952551,1696956042,3491,8990,United Airlines,ORD,MKE
UA388,1696970289,1696973289,3000,5311,United Airlines,MKE,SFO
UA388,1696982841,1696987009,4168,10996,United Airlines,SFO,LAX
UA388,1697001305,1697004202,2897,17136,United Airlines,LAX,SFO
UA388,1697026863,1697034862,7999,12405,United Airlines,SFO,LAX
UA388,1697055129,1697063729,8600,13284,United Airlines,LAX,ORD
UA388,1697083157,1697085303,2146,17103,United Airlines,ORD,MKE
UA388,1697112600,1697120415,7815,4060,United Airlines,MKE,SFO
UA388,1697131608,1697137468,5860,13720,United Airlines,SFO,ORD
UA388,1697151751,1697160503,8752,16975,United Airlines,ORD,MKE
UA388,1697186068,1697193752,7684,19660,United Airlines,MKE,SFO
UA388,1697222132,1697231204,9072,20984,United Airlines,SFO,ORD
UA388,1697253078,1697257299,4221,17350,United Airlines,ORD,MKE
UA388,1697280652,1697286762,6110,17446,United Airlines,MKE,ORD
UA388,1697308089,1697314098,6009,5023,United Airlines,ORD,MKE
UA388,1697329711,1697337482,7771,13432,United Airlines,MKE,LAX
UA388,1697351837,1697362506,10669,4527,United Airlines,LAX,ORD
UA388,1697376947,1697380717,3770,8558,United Airlines,ORD,MKE
UA388,1697389883,1697400038,10155,9802,United Airlines,MKE,LAX
UA388,1697415060,1697425007,9947,11833,United Airlines,LAX,ORD
UA388,1697440246,1697445682,5436,8928,United Airlines,ORD,MKE
UA388,1697457448,1697466764,9316,16620,United Airlines,MKE,SFO
UA388,1697486068,1697489586,3518,11968,United Airlines,SFO,ORD
UA388,1697510254,1697516107,5853,19752,United Airlines,ORD,MKE
UA388,1697537173,1697547639,10466,19438,United Airlines,MKE,SFO
UA388,1697576402,1697582593,6191,9818,United Airlines,SFO,ORD
UA388,1697600610,1697605340,4730,18191,United Airlines,ORD,MKE
UA388,1697633423,1697643332,9909,8234,United Airlines,MKE,LAX
UA388,1697651823,1697656600,4777,4608,United Airlines,LAX,ORD
UA388,1697665511,1697674314,8803,21418,United Airlines,ORD,MKE
UA388,1697696178,1697704332,8154,9330,United Airlines,MKE,ORD
UA388,1697718510,1697723186,4676,9459,United Airlines,ORD,MKE
UA388,1697742580,1697749854,7274,13646,United Airlines,MKE,LAX
UA388,1697767437,1697772583,5146,11750,United Airlines,LAX,SFO
UA388,1697788232,1697792598,4366,10232,United Airlines,SFO,ORD
UA388,1697807905,1697814337,6432,17688,United Airlines,ORD,MKE
UA388,1697835666,1697843292,7626,3697,United Airlines,MKE,ORD
UA388,1697857322,1697866862,9540,10755,United Airlines,ORD,MKE
UA388,1697881491,1697884988,3497,13250,United Airlines,MKE,SFO
UA388,1697904460,1697907933,3473,11422,United Airlines,SFO,LAX
UA388,1697924240,1697929134,4894,17651,United Airlines,LAX,ORD
UA388,1697951651,1697959501,7850,12551,United Airlines,ORD,MKE
UA388,1697977461,1697985961,8500,7747,United Airlines,MKE,LAX
UA388,1697997657,1698005117,7460,17252,United Airlines,LAX,ORD
UA388,1698031319,1698037609,6290,12561,United Airlines,ORD,MKE
UA388,1698059823,1698068457,8634,14332,United Airlines,MKE,ORD
UA388,1698091486,1698095419,3933,9324,United Airlines,ORD,MKE
UA388,1698105530,1698109310,3780,14750,United Airlines,MKE,LAX
UA388,1698126323,1698136421,10098,10237,United Airlines,LAX,ORD
UA388,1698146970,1698156019,9049,5519,United Airlines,ORD,MKE
UA388,1698170112,1698177138,7026,16693,United Airlines,MKE,SFO
UA388,1698199012,1698208725,9713,13696,United Airlines,SFO,ORD
UA388,1698232227,1698240946,8719,4353,United Airlines,ORD,MKE
UA388,1698246119,1698250436,4317,3930,United Airlines,MKE,SFO
UA388,1698260295,1698263225,2930,15683,United Airlines,SFO,LAX
UA388,1698280049,1698284057,4008,5446,United Airlines,LAX,SFO
UA388,1698298412,1698308129,9717,21350,United Airlines,SFO,LAX
UA388,1698335608,1698343014,7406,10303,United Airlines,LAX,SFO
UA388,1698355062,1698360401,5339,12688,United Airlines,SFO,ORD
UA388,1698379560,1698381378,1818,8118,United Airlines,ORD,MKE
UA388,1698399398,1698408072,8674,16899,United Airlines,MKE,SFO
UA388,1698425428,1698435012,9584,10904,United Airlines,SFO,LAX
UA388,1698453569,1698456989,3420,8319,United Airlines,LAX,ORD
UA388,1698466185,1698468415,2230,15666,United Airlines,ORD,MKE
UA388,1698491476,1698501008,9532,10073,United Airlines,MKE,SFO
SW360,1682959659,1682961133,1474,9610,Southwest Airlines,MKE,LAX
SW360,1682978008,1682979337,1329,5953,Southwest Airlines,LAX,SFO
SW360,1682987674,1682989680,2006,18416,Southwest Airlines,SFO,ORD
SW360,1683013432,1683013610,178,12290,Southwest Airlines,ORD,MKE
SW360,1683034737,1683036153,1416,20627,Southwest Airlines,MKE,LAX
SW360,1683061839,1683063356,1517,17397,Southwest Airlines,LAX,SFO
SW360,1683087666,1683088257,591,17449,Southwest Airlines,SFO,LAX
SW360,1683114756,1683119700,4944,19552,Southwest Airlines,LAX,ORD
SW360,1683149853,1683150341,488,15740,Southwest Airlines,ORD,MKE
SW360,1683169745,1683171410,1665,6755,Southwest Airlines,MKE,LAX
SW360,1683187132,1683188864,1732,14783,Southwest Airlines,LAX,SFO
SW360,1683214373,1683215561,1188,9991,Southwest Airlines,SFO,LAX
SW360,1683227991,1683236112,8121,14598,Southwest Airlines,LAX,ORD
SW360,1683257870,1683258583,713,15893,Southwest Airlines,ORD,MKE
SW360,1683274989,1683282074,7085,9887,Southwest Airlines,MKE,ORD
SW360,1683302760,1683304039,1279,7411,Southwest Airlines,ORD,MKE
SW360,1683322185,1683323274,1089,20034,Southwest Airlines,MKE,LAX
SW360,1683346945,1683356613,9668,19442,Southwest Airlines,LAX,ORD
SW360,1683379785,1683380432,647,11645,Southwest Airlines,ORD,MKE
SW360,1683396260,1683396824,564,21290,Southwest Airlines,MKE,SFO
SW360,1683427391,1683430279,2888,5465,Southwest Airlines,SFO,ORD
SW360,1683440025,1683440362,337,17102,Southwest Airlines,ORD,MKE
SW360,1683462962,1683466443,3481,9053,Southwest Airlines,MKE,ORD
SW360,1683482143,1683483140,997,8314,Southwest Airlines,ORD,MKE
SW360,1683493510,1683495992,2482,11644,Southwest Airlines,MKE,ORD
SW360,1683507676,1683507778,102,19383,Southwest Airlines,ORD,MKE
SW360,1683527317,1683527464,147,7529,Southwest Airlines,MKE,SFO
SW360,1683539450,1683548300,8850,3925,Southwest Airlines,SFO,ORD
SW360,1683560656,1683560823,167,5361,Southwest Airlines,ORD,MKE
SW360,1683573979,1683574056,77,6851,Southwest Airlines,MKE,SFO
SW360,1683584839,1683586510,1671,16479,Southwest Airlines,SFO,LAX
SW360,1683605941,1683615285,9344,5270,Southwest Airlines,LAX,ORD
SW360,1683629215,1683630980,1765,15604,Southwest Airlines,ORD,MKE
SW360,1683656516,1683657818,1302,19435,Southwest Airlines,MKE,SFO
SW360,1683686616,1683690357,3741,17267,Southwest Airlines,SFO,ORD
SW360,1683711061,1683711677,616,20465,Southwest Airlines,ORD,MKE
SW360,1683737178,1683738575,1397,6687,Southwest Airlines,MKE,SFO
SW360,1683747581,1683747921,340,7036,Southwest Airlines,SFO,LAX
SW360,1683758594,1683764477,5883,9385,Southwest Airlines,LAX,ORD
SW360,1683775742,1683776146,404,5010,Southwest Airlines,ORD,MKE
SW360,1683787220,1683787742,522,5636,Southwest Airlines,MKE,SFO
SW360,1683800770,1683801924,1154,14525,Southwest Airlines,SFO,LAX
SW360,1683817316,1683818617,1301,17223,Southwest Airlines,LAX,SFO
SW360,1683837712,1683838261,549,5865,Southwest Airlines,SFO,LAX
SW360,1683847936,1683848504,568,19679,Southwest Airlines,LAX,SFO
SW360,1683874006,1683874525,519,12278,Southwest Airlines,SFO,LAX
SW360,1683890217,1683891539,1322,7049,Southwest Airlines,LAX,SFO
SW360,1683902949,1683903254,305,18027,Southwest Airlines,SFO,LAX
SW360,1683924993,1683926136,1143,18810,Southwest Airlines,LAX,SFO
SW360,1683949977,1683951680,1703,5828,Southwest Airlines,SFO,LAX
SW360,1683964331,1683964872,541,5793,Southwest Airlines,LAX,SFO
SW360,1683978639,1683979713,1074,20862,Southwest Airlines,SFO,LAX
SW360,1684000830,1684002826,1996,21019,Southwest Airlines,LAX,ORD
SW360,1684034203,1684034641,438,8745,Southwest Airlines,ORD,MKE
SW360,1684052456,1684053941,1485,6505,Southwest Airlines,MKE,SFO
SW360,1684069783,1684076617,6834,4759,Southwest Airlines,SFO,ORD
SW360,1684088256,1684089137,881,6113,Southwest Airlines,ORD,MKE
SW360,1684098285,1684099998,1713,16617,Southwest Airlines,MKE,SFO
SW360,1684117797,1684123304,5507,6491,Southwest Airlines,SFO,ORD
SW360,1684131812,1684133275,1463,18895,Southwest Airlines,ORD,MKE
SW360,1684158753,1684160441,1688,11005,Southwest Airlines,MKE,SFO
SW360,1684176995,1684177615,620,5509,Southwest Airlines,SFO,LAX
SW360,1684190204,1684191645,1441,15386,Southwest Airlines,LAX,SFO
SW360,1684216265,1684224008,7743,10397,Southwest Airlines,SFO,ORD
SW360,1684238789,1684240134,1345,4702,Southwest Airlines,ORD,MKE
SW360,1684247845,1684248501,656,21002,Southwest Airlines,MKE,SFO
SW360,1684276369,1684286172,9803,20523,Southwest Airlines,SFO,ORD
SW360,1684308067,1684308982,915,20052,Southwest Airlines,ORD,MKE
SW360,1684331503,1684331934,431,11856,Southwest Airlines,MKE,SFO
SW360,1684346446,1684352709,6263,10092,Southwest Airlines,SFO,ORD
SW360,1684367648,1684369338,1690,11680,Southwest Airlines,ORD,MKE
SW360,1684386265,1684386978,713,10001,Southwest Airlines,MKE,LAX
SW360,1684404010,1684405320,1310,16108,Southwest Airlines,LAX,SFO
SW360,1684424712,1684429422,4710,18794,Southwest Airlines,SFO,ORD
SW360,1684454235,1684455837,1602,19141,Southwest Airlines,ORD,MKE
SW360,1684478979,1684484287,5308,20879,Southwest Airlines,MKE,ORD
SW360,1684506898,1684507906,1008,17596,Southwest Airlines,ORD,MKE
SW360,1684534889,1684535887,998,8502,Southwest Airlines,MKE,LAX
SW360,1684553209,1684562537,9328,8322,Southwest Airlines,LAX,ORD
SW360,1684581615,1684581866,251,15656,Southwest Airlines,ORD,MKE
SW360,1684602780,1684609874,7094,12470,Southwest Airlines,MKE,ORD
SW360,1684628449,1684629471,1022,8401,Southwest Airlines,ORD,MKE
SW360,1684639339,1684649896,10557,3996,Southwest Airlines,MKE,ORD
SW360,1684656409,1684657680,1271,13884,Southwest Airlines,ORD,MKE
SW360,1684679349,1684682130,2781,3717,Southwest Airlines,MKE,ORD
SW360,1684691667,1684693023,1356,10672,Southwest Airlines,ORD,MKE
SW360,1684714296,1684715424,1128,19924,Southwest Airlines,MKE,SFO
SW360,1684744823,1684753716,8893,7088,Southwest Airlines,SFO,ORD
SW360,1684770671,1684772274,1603,18541,Southwest Airlines,ORD,MKE
SW360,1684797865,1684797966,101,5124,Southwest Airlines,MKE,SFO
SW360,1684810708,1684811657,949,11254,Southwest Airlines,SFO,LAX
SW360,1684823853,1684834567,10714,6870,Southwest Airlines,LAX,ORD
SW360,1684846734,1684847472,738,3723,Southwest Airlines,ORD,MKE
SW360,1684859228,1684860271,1043,19118,Southwest Airlines,MKE,SFO
SW360,1684881402,1684884417,3015,17150,Southwest Airlines,SFO,ORD
SW360,1684903072,1684903320,248,8969,Southwest Airlines,ORD,MKE
SW360,1684916599,1684918249,1650,9470,Southwest Airlines,MKE,LAX
SW360,1684931374,1684932626,1252,21099,Southwest Airlines,LAX,SFO
SW360,1684964203,1684965396,1193,9105,Southwest Airlines,SFO,LAX
SW360,1684978222,1684985784,7562,18447,Southwest Airlines,LAX,ORD
SW360,1685011018,1685011558,540,10228,Southwest Airlines,ORD,MKE
SW360,1685022258,1685023598,1340,5521,Southwest Airlines,MKE,SFO
SW360,1685029450,1685030097,647,9032,Southwest Airlines,SFO,LAX
SW360,1685046823,1685047199,376,7403,Southwest Airlines,LAX,SFO
SW360,1685059007,1685060072,1065,16359,Southwest Airlines,SFO,LAX
SW360,1685085666,1685094870,9204,6744,Southwest Airlines,LAX,ORD
SW360,1685110647,1685111930,1283,16654,Southwest Airlines,ORD,MKE
SW360,1685130181,1685131379,1198,11595,Southwest Airlines,MKE,SFO
SW360,1685148786,1685149336,550,7634,Southwest Airlines,SFO,LAX
SW360,1685160275,1685161829,1554,3613,Southwest Airlines,LAX,SFO
SW360,1685170930,1685173150,2220,9033,Southwest Airlines,SFO,ORD
SW360,1685191275,1685192620,1345,5808,Southwest Airlines,ORD,MKE
SW360,1685201542,1685201840,298,13512,Southwest Airlines,MKE,SFO
SW360,1685221651,1685229782,8131,17331,Southwest Airlines,SFO,ORD
SW360,1685255235,1685255325,90,9774,Southwest Airlines,ORD,MKE
SW360,1685274336,1685275764,1428,14606,Southwest Airlines,MKE,SFO
SW360,1685300754,1685305303,4549,12587,Southwest Airlines,SFO,ORD
SW360,1685319090,1685319408,318,15812,Southwest Airlines,ORD,MKE
SW360,1685341272,1685345750,4478,21322,Southwest Airlines,MKE,ORD
SW360,1685367848,1685368515,667,9628,Southwest Airlines,ORD,MKE
SW360,1685388805,1685394297,5492,3750,Southwest Airlines,MKE,ORD
SW360,1685405340,1685406306,966,9730,Southwest Airlines,ORD,MKE
SW360,1685422353,1685423239,886,8304,Southwest Airlines,MKE,SFO
SW360,1685438290,1685439808,1518,19536,Southwest Airlines,SFO,LAX
SW360,1685467030,1685471209,4179,5960,Southwest Airlines,LAX,ORD
SW360,1685482080,1685482093,13,19613,Southwest Airlines,ORD,MKE
SW360,1685511856,1685516923,5067,16978,Southwest Airlines,MKE,ORD
SW360,1685538805,1685539980,1175,14933,Southwest Airlines,ORD,MKE
SW360,1685565156,1685566294,1138,3905,Southwest Airlines,MKE,LAX
SW360,1685576064,1685577674,1610,20233,Southwest Airlines,LAX,SFO
SW360,1685603505,1685613106,9601,15646,Southwest Airlines,SFO,ORD
SW360,1685630535,1685631722,1187,6227,Southwest Airlines,ORD,MKE
SW360,1685638313,1685642288,3975,12565,Southwest Airlines,MKE,ORD
SW360,1685656405,1685656484,79,5056,Southwest Airlines,ORD,MKE
SW360,1685669319,1685669832,513,15055,Southwest Airlines,MKE,SFO
SW360,1685690844,1685695962,5118,12238,Southwest Airlines,SFO,ORD
SW360,1685708326,1685709578,1252,6996,Southwest Airlines,ORD,MKE
SW360,1685724776,1685724801,25,5119,Southwest Airlines,MKE,LAX
SW360,1685730827,1685732428,1601,18013,Southwest Airlines,LAX,SFO
SW360,1685751961,1685753142,1181,10617,Southwest Airlines,SFO,LAX
SW360,1685770227,1685771288,1061,5499,Southwest Airlines,LAX,SFO
SW360,1685777043,1685777269,226,11724,Southwest Airlines,SFO,LAX
SW360,1685791484,1685799107,7623,20690,Southwest Airlines,LAX,ORD
SW360,1685828264,1685829122,858,14451,Southwest Airlines,ORD,MKE
SW360,1685844894,1685846063,1169,9531,Southwest Airlines,MKE,SFO
SW360,1685859933,1685860686,753,8950,Southwest Airlines,SFO,LAX
SW360,1685874682,1685880100,5418,16640,Southwest Airlines,LAX,ORD
SW360,1685899615,1685900253,638,20008,Southwest Airlines,ORD,MKE
SW360,1685927505,1685927527,22,20622,Southwest Airlines,MKE,SFO
SW360,1685956459,1685957415,956,15544,Southwest Airlines,SFO,LAX
SW360,1685974420,1685975598,1178,15926,Southwest Airlines,LAX,SFO
SW360,1685994340,1686000820,6480,18242,Southwest Airlines,SFO,ORD
SW360,1686028195,1686028452,257,12596,Southwest Airlines,ORD,MKE
SW360,1686042590,1686042971,381,20821,Southwest Airlines,MKE,SFO
SW360,1686070749,1686071436,687,18511,Southwest Airlines,SFO,LAX
SW360,1686096899,1686099548,2649,8579,Southwest Airlines,LAX,ORD
SW360,1686114806,1686115428,622,13030,Southwest Airlines,ORD,MKE
SW360,1686131651,1686132688,1037,8549,Southwest Airlines,MKE,SFO
SW360,1686145496,1686146950,1454,14601,Southwest Airlines,SFO,LAX
SW360,1686171448,1686179189,7741,6623,Southwest Airlines,LAX,ORD
SW360,1686195933,1686197404,1471,13294,Southwest Airlines,ORD,MKE
SW360,1686220588,1686221106,518,16907,Southwest Airlines,MKE,LAX
SW360,1686238176,1686240973,2797,13539,Southwest Airlines,LAX,ORD
SW360,1686265181,1686266576,1395,7359,Southwest Airlines,ORD,MKE
SW360,1686284365,1686289126,4761,15966,Southwest Airlines,MKE,ORD
SW360,1686306977,1686308219,1242,19704,Southwest Airlines,ORD,MKE
SW360,1686333811,1686335574,1763,8512,Southwest Airlines,MKE,SFO
SW360,1686345767,1686355103,9336,10899,Southwest Airlines,SFO,ORD
SW360,1686370399,1686370742,343,16564,Southwest Airlines,ORD,MKE
SW360,1686388681,1686389195,514,16509,Southwest Airlines,MKE,SFO
SW360,1686415238,1686416817,1579,5228,Southwest Airlines,SFO,LAX
SW360,1686429320,1686430865,1545,6731,Southwest Airlines,LAX,SFO
SW360,1686442778,1686443466,688,16159,Southwest Airlines,SFO,LAX
SW360,1686459707,1686464755,5048,6217,Southwest Airlines,LAX,ORD
SW360,1686479820,1686481618,1798,13486,Southwest Airlines,ORD,MKE
SW360,1686504103,1686504588,485,10889,Southwest Airlines,MKE,LAX
SW360,1686523721,1686534008,10287,20754,Southwest Airlines,LAX,ORD
SW360,1686559940,1686560538,598,9490,Southwest Airlines,ORD,MKE
SW360,1686577874,1686578549,675,11130,Southwest Airlines,MKE,SFO
SW360,1686590110,1686590436,326,21137,Southwest Airlines,SFO,LAX
SW360,1686618426,1686627788,9362,7943,Southwest Airlines,LAX,ORD
SW360,1686642761,1686642916,155,4348,Southwest Airlines,ORD,MKE
SW360,1686655606,1686656417,811,18352,Southwest Airlines,MKE,LAX
SW360,1686679680,1686680116,436,20828,Southwest Airlines,LAX,SFO
SW360,1686707790,1686710021,2231,7604,Southwest Airlines,SFO,ORD
SW360,1686718190,1686719368,1178,8057,Southwest Airlines,ORD,MKE
SW360,1686731504,1686732737,1233,16751,Southwest Airlines,MKE,SFO
SW360,1686755986,1686756963,977,11469,Southwest Airlines,SFO,LAX
SW360,1686772822,1686774013,1191,18082,Southwest Airlines,LAX,SFO
SW360,1686802868,1686804327,1459,15039,Southwest Airlines,SFO,LAX
SW360,1686819418,1686828641,9223,7892,Southwest Airlines,LAX,ORD
SW360,1686845093,1686846569,1476,15287,Southwest Airlines,ORD,MKE
SW360,1686864685,1686865645,960,12741,Southwest Airlines,MKE,LAX
SW360,1686884726,1686885899,1173,7842,Southwest Airlines,LAX,SFO
SW360,1686901859,1686903426,1567,9285,Southwest Airlines,SFO,LAX
SW360,1686914042,1686914728,686,11040,Southwest Airlines,LAX,SFO
SW360,1686930512,1686932267,1755,10782,Southwest Airlines,SFO,LAX
SW360,1686951267,1686960967,9700,6034,Southwest Airlines,LAX,ORD
SW360,1686972993,1686973550,557,11199,Southwest Airlines,ORD,MKE
SW360,1686994710,1687004445,9735,11482,Southwest Airlines,MKE,ORD
SW360,1687018843,1687019623,780,16355,Southwest Airlines,ORD,MKE
SW360,1687040947,1687042516,1569,5823,Southwest Airlines,MKE,SFO
SW360,1687050906,1687054239,3333,19294,Southwest Airlines,SFO,ORD
SW360,1687077095,1687078005,910,16133,Southwest Airlines,ORD,MKE
SW360,1687099438,1687110160,10722,5575,Southwest Airlines,MKE,ORD
SW360,1687117649,1687118210,561,6414,Southwest Airlines,ORD,MKE
SW360,1687129687,1687131200,1513,21378,Southwest Airlines,MKE,SFO
SW360,1687153163,1687160461,7298,19891,Southwest Airlines,SFO,ORD
SW360,1687186608,1687186695,87,14060,Southwest Airlines,ORD,MKE
SW360,1687205209,1687205723,514,8528,Southwest Airlines,MKE,SFO
SW360,1687219100,1687224906,5806,21350,Southwest Airlines,SFO,ORD
SW360,1687247523,1687247894,371,19537,Southwest Airlines,ORD,MKE
SW360,1687272457,1687275710,3253,16128,Southwest Airlines,MKE,ORD
SW360,1687296300,1687297755,1455,19165,Southwest Airlines,ORD,MKE
SW360,1687319774,1687319933,159,9029,Southwest Airlines,MKE,LAX
SW360,1687335708,1687336821,1113,6628,Southwest Airlines,LAX,SFO
SW360,1687350130,1687351718,1588,12327,Southwest Airlines,SFO,LAX
SW360,1687366331,1687368056,1725,19030,Southwest Airlines,LAX,SFO
SW360,1687389192,1687389455,263,3882,Southwest Airlines,SFO,LAX
SW360,1687393871,1687398051,4180,8010,Southwest Airlines,LAX,ORD
SW360,1687409826,1687409929,103,10892,Southwest Airlines,ORD,MKE
SW360,1687430702,1687430863,161,12841,Southwest Airlines,MKE,SFO
SW360,1687450364,1687454312,3948,18218,Southwest Airlines,SFO,ORD
SW360,1687473464,1687474299,835,17833,Southwest Airlines,ORD,MKE
SW360,1687494319,1687504859,10540,16138,Southwest Airlines,MKE,ORD
SW360,1687527178,1687528260,1082,9536,Southwest Airlines,ORD,MKE
SW360,1687538386,1687539703,1317,9488,Southwest Airlines,MKE,SFO
SW360,1687551977,1687557253,5276,4112,Southwest Airlines,SFO,ORD
SW360,1687563413,1687564211,798,13637,Southwest Airlines,ORD,MKE
SW360,1687579491,1687588767,9276,20523,Southwest Airlines,MKE,ORD
SW360,1687618765,1687620477,1712,13424,Southwest Airlines,ORD,MKE
SW360,1687637957,1687639260,1303,21436,Southwest Airlines,MKE,LAX
SW360,1687664335,1687664640,305,21331,Southwest Airlines,LAX,SFO
SW360,1687691254,1687692525,1271,16826,Southwest Airlines,SFO,LAX
SW360,1687713344,1687713861,517,19350,Southwest Airlines,LAX,SFO
SW360,1687734696,1687735672,976,19259,Southwest Airlines,SFO,LAX
SW360,1687756677,1687757537,860,8511,Southwest Airlines,LAX,SFO
SW360,1687768551,1687777952,9401,3899,Southwest Airlines,SFO,ORD
SW360,1687790851,1687792625,1774,17124,Southwest Airlines,ORD,MKE
SW360,1687819829,1687821774,1945,5486,Southwest Airlines,MKE,ORD
SW360,1687837385,1687838027,642,7443,Southwest Airlines,ORD,MKE
SW360,1687846265,1687846397,132,9061,Southwest Airlines,MKE,LAX
SW360,1687857168,1687858211,1043,4310,Southwest Airlines,LAX,SFO
SW360,1687863053,1687863183,130,12800,Southwest Airlines,SFO,LAX
SW360,1687880217,1687888152,7935,12995,Southwest Airlines,LAX,ORD
SW360,1687901355,1687901795,440,10578,Southwest Airlines,ORD,MKE
SW360,1687918916,1687920382,1466,16562,Southwest Airlines,MKE,LAX
SW360,1687946981,1687947599,618,8421,Southwest Airlines,LAX,SFO
SW360,1687961127,1687966088,4961,14201,Southwest Airlines,SFO,ORD
SW360,1687987066,1687987100,34,14195,Southwest Airlines,ORD,MKE
SW360,1688004625,1688014728,10103,7984,Southwest Airlines,MKE,ORD
SW360,1688025312,1688025576,264,6744,Southwest Airlines,ORD,MKE
SW360,1688039992,1688049174,9182,13712,Southwest Airlines,MKE,ORD
SW360,1688072030,1688073620,1590,12530,Southwest Airlines,ORD,MKE
SW360,1688089591,1688099492,9901,8579,Southwest Airlines,MKE,ORD
SW360,1688116545,1688118009,1464,11353,Southwest Airlines,ORD,MKE
SW360,1688130932,1688131179,247,17976,Southwest Airlines,MKE,SFO
SW360,1688155427,1688155608,181,18945,Southwest Airlines,SFO,LAX
SW360,1688178436,1688182167,3731,4207,Southwest Airlines,LAX,ORD
SW360,1688191586,1688192427,841,4510,Southwest Airlines,ORD,MKE
SW360,1688203479,1688204486,1007,12391,Southwest Airlines,MKE,LAX
SW360,1688227568,1688230435,2867,14064,Southwest Airlines,LAX,ORD
SW360,1688252674,1688254260,1586,10983,Southwest Airlines,ORD,MKE
SW360,1688268403,1688269868,1465,5385,Southwest Airlines,MKE,SFO
SW360,1688280887,1688281596,709,11861,Southwest Airlines,SFO,LAX
SW360,1688297970,1688299256,1286,10336,Southwest Airlines,LAX,SFO
SW360,1688319834,1688320402,568,4475,Southwest Airlines,SFO,LAX
SW360,1688332386,1688335164,2778,7715,Southwest Airlines,LAX,ORD
SW360,1688348441,1688348574,133,11295,Southwest Airlines,ORD,MKE
SW360,1688370308,1688371742,1434,11875,Southwest Airlines,MKE,LAX
SW360,1688391802,1688393238,1436,14976,Southwest Airlines,LAX,SFO
SW360,1688410551,1688418353,7802,19024,Southwest Airlines,SFO,ORD
SW360,1688437690,1688438995,1305,21340,Southwest Airlines,ORD,MKE
SW360,1688462570,1688463321,751,19431,Southwest Airlines,MKE,SFO
SW360,1688489528,1688498349,8821,10123,Southwest Airlines,SFO,ORD
SW360,1688511246,1688512379,1133,4929,Southwest Airlines,ORD,MKE
SW360,1688518814,1688520786,1972,16651,Southwest Airlines,MKE,ORD
SW360,1688542447,1688543160,713,15329,Southwest Airlines,ORD,MKE
SW360,1688566142,1688566837,695,18002,Southwest Airlines,MKE,SFO
SW360,1688593337,1688600351,7014,8122,Southwest Airlines,SFO,ORD
SW360,1688616175,1688616281,106,18764,Southwest Airlines,ORD,MKE
SW360,1688636446,1688645057,8611,16952,Southwest Airlines,MKE,ORD
SW360,1688668119,1688668464,345,7782,Southwest Airlines,ORD,MKE
SW360,1688680676,1688681651,975,5713,Southwest Airlines,MKE,SFO
SW360,1688691065,1688692074,1009,14496,Southwest Airlines,SFO,LAX
SW360,1688711895,1688713659,1764,8898,Southwest Airlines,LAX,SFO
SW360,1688724196,1688724918,722,18171,Southwest Airlines,SFO,LAX
SW360,1688743925,1688753249,9324,6929,Southwest Airlines,LAX,ORD
SW360,1688770799,1688770969,170,15609,Southwest Airlines,ORD,MKE
SW360,1688790522,1688801282,10760,11734,Southwest Airlines,MKE,ORD
SW360,1688823135,1688823421,286,18782,Southwest Airlines,ORD,MKE
SW360,1688844375,1688844992,617,12859,Southwest Airlines,MKE,SFO
SW360,1688859164,1688859296,132,6239,Southwest Airlines,SFO,LAX
SW360,1688869673,1688873853,4180,6135,Southwest Airlines,LAX,ORD
SW360,1688883475,1688884715,1240,13286,Southwest Airlines,ORD,MKE
SW360,1688907783,1688909571,1788,6696,Southwest Airlines,MKE,LAX
SW360,1688924269,1688933188,8919,17924,Southwest Airlines,LAX,ORD
SW360,1688961468,1688962523,1055,12826,Southwest Airlines,ORD,MKE
SW360,1688985737,1688986816,1079,12518,Southwest Airlines,MKE,SFO
SW360,1689008817,1689009394,577,5786,Southwest Airlines,SFO,LAX
SW360,1689020135,1689023788,3653,9103,Southwest Airlines,LAX,ORD
SW360,1689038039,1689039603,1564,13387,Southwest Airlines,ORD,MKE
SW360,1689057854,1689058004,150,7631,Southwest Airlines,MKE,SFO
SW360,1689065849,1689072328,6479,7499,Southwest Airlines,SFO,ORD
SW360,1689081214,1689081536,322,16103,Southwest Airlines,ORD,MKE
SW360,1689103274,1689103288,14,20993,Southwest Airlines,MKE,LAX
SW360,1689134417,1689136072,1655,12444,Southwest Airlines,LAX,SFO
SW360,1689155038,1689165256,10218,19872,Southwest Airlines,SFO,ORD
SW360,1689191087,1689191446,359,21148,Southwest Airlines,ORD,MKE
SW360,1689220473,1689220765,292,20246,Southwest Airlines,MKE,SFO
SW360,1689250617,1689251005,388,10650,Southwest Airlines,SFO,LAX
SW360,1689266341,1689275186,8845,7599,Southwest Airlines,LAX,ORD
SW360,1689285224,1689286254,1030,8499,Southwest Airlines,ORD,MKE
SW360,1689301329,1689302198,869,13090,Southwest Airlines,MKE,SFO
SW360,1689325139,1689327787,2648,17228,Southwest Airlines,SFO,ORD
SW360,1689346916,1689347829,913,3933,Southwest Airlines,ORD,MKE
SW360,1689358206,1689359986,1780,6688,Southwest Airlines,MKE,SFO
SW360,1689372860,1689380469,7609,13985,Southwest Airlines,SFO,ORD
SW360,1689397872,1689398205,333,16269,Southwest Airlines,ORD,MKE
SW360,1689415616,1689415645,29,6232,Southwest Airlines,MKE,LAX
SW360,1689423008,1689424001,993,14632,Southwest Airlines,LAX,SFO
SW360,1689446217,1689452274,6057,11126,Southwest Airlines,SFO,ORD
SW360,1689464037,1689464763,726,12079,Southwest Airlines,ORD,MKE
SW360,1689485794,1689492980,7186,11644,Southwest Airlines,MKE,ORD
SW360,1689514715,1689515683,968,16704,Southwest Airlines,ORD,MKE
SW360,1689543094,1689543563,469,20217,Southwest Airlines,MKE,LAX
SW360,1689566598,1689570196,3598,4936,Southwest Airlines,LAX,ORD
SW360,1689578324,1689578451,127,5210,Southwest Airlines,ORD,MKE
SW360,1689587493,1689588754,1261,8880,Southwest Airlines,MKE,LAX
SW360,1689605299,1689605750,451,13151,Southwest Airlines,LAX,SFO
SW360,1689620754,1689621347,593,7045,Southwest Airlines,SFO,LAX
SW360,1689632723,1689633336,613,5752,Southwest Airlines,LAX,SFO
SW360,1689648129,1689648132,3,20630,Southwest Airlines,SFO,LAX
SW360,1689671426,1689672293,867,4392,Southwest Airlines,LAX,SFO
SW360,1689681729,1689686438,4709,17557,Southwest Airlines,SFO,ORD
SW360,1689705518,1689705854,336,18180,Southwest Airlines,ORD,MKE
SW360,1689724775,1689733485,8710,20299,Southwest Airlines,MKE,ORD
SW360,1689759059,1689759329,270,15662,Southwest Airlines,ORD,MKE
SW360,1689779950,1689785916,5966,10497,Southwest Airlines,MKE,ORD
SW360,1689805163,1689805733,570,16900,Southwest Airlines,ORD,MKE
SW360,1689829590,1689835190,5600,18478,Southwest Airlines,MKE,ORD
SW360,1689854415,1689856177,1762,17638,Southwest Airlines,ORD,MKE
SW360,1689880775,1689890054,9279,7841,Southwest Airlines,MKE,ORD
SW360,1689899722,1689899886,164,16596,Southwest Airlines,ORD,MKE
SW360,1689923096,1689923509,413,8432,Southwest Airlines,MKE,LAX
SW360,1689939088,1689942506,3418,15059,Southwest Airlines,LAX,ORD
SW360,1689966004,1689966034,30,19619,Southwest Airlines,ORD,MKE
SW360,1689993450,1689995040,1590,11778,Southwest Airlines,MKE,SFO
SW360,1690008088,1690012427,4339,14525,Southwest Airlines,SFO,ORD
SW360,1690037412,1690038304,892,6397,Southwest Airlines,ORD,MKE
SW360,1690048396,1690053281,4885,19609,Southwest Airlines,MKE,ORD
SW360,1690080904,1690081758,854,15793,Southwest Airlines,ORD,MKE
SW360,1690105573,1690107077,1504,8565,Southwest Airlines,MKE,SFO
SW360,1690125684,1690130882,5198,17602,Southwest Airlines,SFO,ORD
SW360,1690154038,1690155723,1685,20600,Southwest Airlines,ORD,MKE
SW360,1690178158,1690179888,1730,10099,Southwest Airlines,MKE,LAX
SW360,1690199229,1690200781,1552,18464,Southwest Airlines,LAX,SFO
SW360,1690223078,1690231363,8285,18279,Southwest Airlines,SFO,ORD
SW360,1690250070,1690251385,1315,17183,Southwest Airlines,ORD,MKE
SW360,1690275611,1690285981,10370,9742,Southwest Airlines,MKE,ORD
SW360,1690301726,1690302236,510,7329,Southwest Airlines,ORD,MKE
SW360,1690319593,1690319823,230,13020,Southwest Airlines,MKE,LAX
SW360,1690343539,1690351386,7847,7046,Southwest Airlines,LAX,ORD
SW360,1690362772,1690364511,1739,9281,Southwest Airlines,ORD,MKE
SW360,1690382445,1690388161,5716,9793,Southwest Airlines,MKE,ORD
SW360,1690401858,1690402353,495,13173,Southwest Airlines,ORD,MKE
SW360,1690423345,1690425057,1712,20004,Southwest Airlines,MKE,SFO
SW360,1690449502,1690450842,1340,9156,Southwest Airlines,SFO,LAX
SW360,1690465376,1690465452,76,9444,Southwest Airlines,LAX,SFO
SW360,1690484894,1690485175,281,18831,Southwest Airlines,SFO,LAX
SW360,1690504656,1690506142,1486,19916,Southwest Airlines,LAX,SFO
SW360,1690527547,1690527917,370,17663,Southwest Airlines,SFO,LAX
SW360,1690555781,1690556927,1146,15641,Southwest Airlines,LAX,SFO
SW360,1690581606,1690590450,8844,6075,Southwest Airlines,SFO,ORD
SW360,1690604407,1690604960,553,18380,Southwest Airlines,ORD,MKE
SW360,1690630686,1690631883,1197,5470,Southwest Airlines,MKE,SFO
SW360,1690640565,1690642167,1602,9953,Southwest Airlines,SFO,LAX
SW360,1690656725,1690663215,6490,12209,Southwest Airlines,LAX,ORD
SW360,1690683943,1690685616,1673,15110,Southwest Airlines,ORD,MKE
SW360,1690709010,1690716009,6999,4908,Southwest Airlines,MKE,ORD
SW360,1690727178,1690727547,369,7821,Southwest Airlines,ORD,MKE
SW360,1690741744,1690743348,1604,5000,Southwest Airlines,MKE,SFO
SW360,1690755691,1690755952,261,19194,Southwest Airlines,SFO,LAX
SW360,1690785750,1690786857,1107,5406,Southwest Airlines,LAX,SFO
SW360,1690799984,1690799985,1,18978,Southwest Airlines,SFO,LAX
SW360,1690825306,1690827361,2055,16884,Southwest Airlines,LAX,ORD
SW360,1690848910,1690850498,1588,9891,Southwest Airlines,ORD,MKE
SW360,1690869756,1690869928,172,3809,Southwest Airlines,MKE,SFO
SW360,1690882309,1690885114,2805,19014,Southwest Airlines,SFO,ORD
SW360,1690911527,1690912109,582,16521,Southwest Airlines,ORD,MKE
SW360,1690938614,1690938799,185,15237,Southwest Airlines,MKE,LAX
SW360,1690961717,1690971383,9666,11836,Southwest Airlines,LAX,ORD
SW360,1690991772,1690993392,1620,16252,Southwest Airlines,ORD,MKE
SW360,1691009673,1691011245,1572,15760,Southwest Airlines,MKE,LAX
SW360,1691036230,1691036443,213,4194,Southwest Airlines,LAX,SFO
SW360,1691047611,1691048672,1061,21281,Southwest Airlines,SFO,LAX
SW360,1691075646,1691076718,1072,20538,Southwest Airlines,LAX,SFO
SW360,1691097827,1691098621,794,15966,Southwest Airlines,SFO,LAX
SW360,1691124923,1691125938,1015,11475,Southwest Airlines,LAX,SFO
SW360,1691142779,1691143124,345,7535,Southwest Airlines,SFO,LAX
SW360,1691151394,1691151901,507,4250,Southwest Airlines,LAX,SFO
SW360,1691162171,1691162618,447,12214,Southwest Airlines,SFO,LAX
SW360,1691183843,1691185323,1480,9756,Southwest Airlines,LAX,SFO
SW360,1691201753,1691202783,1030,14845,Southwest Airlines,SFO,LAX
SW360,1691227590,1691228604,1014,18653,Southwest Airlines,LAX,SFO
SW360,1691254957,1691256444,1487,21573,Southwest Airlines,SFO,LAX
SW360,1691281149,1691286555,5406,3634,Southwest Airlines,LAX,ORD
SW360,1691298258,1691298808,550,9568,Southwest Airlines,ORD,MKE
SW360,1691319053,1691320017,964,8245,Southwest Airlines,MKE,LAX
SW360,1691333047,1691333720,673,6857,Southwest Airlines,LAX,SFO
SW360,1691351008,1691352859,1851,14251,Southwest Airlines,SFO,ORD
SW360,1691371584,1691372889,1305,17913,Southwest Airlines,ORD,MKE
SW360,1691391121,1691391716,595,19233,Southwest Airlines,MKE,LAX
SW360,1691417524,1691420395,2871,8949,Southwest Airlines,LAX,ORD
SW360,1691438707,1691440140,1433,12851,Southwest Airlines,ORD,MKE
SW360,1691460914,1691462014,1100,6061,Southwest Airlines,MKE,LAX
SW360,1691477283,1691477871,588,7797,Southwest Airlines,LAX,SFO
SW360,1691487212,1691488335,1123,17059,Southwest Airlines,SFO,LAX
SW360,1691505519,1691505911,392,7689,Southwest Airlines,LAX,SFO
SW360,1691519951,1691521134,1183,8470,Southwest Airlines,SFO,LAX
SW360,1691536214,1691536711,497,3669,Southwest Airlines,LAX,SFO
SW360,1691542707,1691551390,8683,12271,Southwest Airlines,SFO,ORD
SW360,1691567516,1691568105,589,18832,Southwest Airlines,ORD,MKE
SW360,1691596834,1691598445,1611,20902,Southwest Airlines,MKE,LAX
SW360,1691621306,1691623901,2595,16815,Southwest Airlines,LAX,ORD
SW360,1691647115,1691647412,297,21385,Southwest Airlines,ORD,MKE
SW360,1691678721,1691686600,7879,18251,Southwest Airlines,MKE,ORD
SW360,1691706112,1691706707,595,18644,Southwest Airlines,ORD,MKE
SW360,1691734069,1691735108,1039,7191,Southwest Airlines,MKE,SFO
SW360,1691745430,1691750275,4845,5660,Southwest Airlines,SFO,ORD
SW360,1691761196,1691761254,58,9721,Southwest Airlines,ORD,MKE
SW360,1691779413,1691782063,2650,9381,Southwest Airlines,MKE,ORD
SW360,1691791720,1691792550,830,5729,Southwest Airlines,ORD,MKE
SW360,1691800302,1691810214,9912,10872,Southwest Airlines,MKE,ORD
SW360,1691829401,1691830815,1414,5099,Southwest Airlines,ORD,MKE
SW360,1691836099,1691836842,743,20434,Southwest Airlines,MKE,SFO
SW360,1691864964,1691865653,689,16786,Southwest Airlines,SFO,LAX
SW360,1691887665,1691892755,5090,9793,Southwest Airlines,LAX,ORD
SW360,1691906736,1691906919,183,7666,Southwest Airlines,ORD,MKE
SW360,1691922003,1691922080,77,15077,Southwest Airlines,MKE,SFO
SW360,1691943186,1691947116,3930,4036,Southwest Airlines,SFO,ORD
SW360,1691955469,1691956476,1007,5187,Southwest Airlines,ORD,MKE
SW360,1691969569,1691979670,10101,5870,Southwest Airlines,MKE,ORD
SW360,1691994203,1691995757,1554,5094,Southwest Airlines,ORD,MKE
SW360,1692011234,1692011919,685,14950,Southwest Airlines,MKE,LAX
SW360,1692031862,1692042153,10291,19655,Southwest Airlines,LAX,ORD
SW360,1692063839,1692064455,616,5157,Southwest Airlines,ORD,MKE
SW360,1692074782,1692075878,1096,4403,Southwest Airlines,MKE,SFO
SW360,1692090197,1692091667,1470,10020,Southwest Airlines,SFO,LAX
SW360,1692107520,1692113945,6425,4536,Southwest Airlines,LAX,ORD
SW360,1692119033,1692119864,831,16830,Southwest Airlines,ORD,MKE
SW360,1692140628,1692141976,1348,9729,Southwest Airlines,MKE,LAX
SW360,1692158532,1692166946,8414,17400,Southwest Airlines,LAX,ORD
SW360,1692193254,1692193327,73,13913,Southwest Airlines,ORD,MKE
SW360,1692215598,1692217202,1604,12048,Southwest Airlines,MKE,LAX
SW360,1692238934,1692249602,10668,4712,Southwest Airlines,LAX,ORD
SW360,1692264169,1692264312,143,12673,Southwest Airlines,ORD,MKE
SW360,1692278911,1692279240,329,18494,Southwest Airlines,MKE,LAX
SW360,1692307968,1692316434,8466,3678,Southwest Airlines,LAX,ORD
SW360,1692325613,1692327132,1519,10998,Southwest Airlines,ORD,MKE
SW360,1692338165,1692338726,561,5059,Southwest Airlines,MKE,LAX
SW360,1692351386,1692359417,8031,21334,Southwest Airlines,LAX,ORD
SW360,1692388639,1692389358,719,14253,Southwest Airlines,ORD,MKE
SW360,1692408873,1692410501,1628,14732,Southwest Airlines,MKE,LAX
SW360,1692426895,1692434055,7160,17892,Southwest Airlines,LAX,ORD
SW360,1692459087,1692460756,1669,8890,Southwest Airlines,ORD,MKE
SW360,1692478993,1692484513,5520,13685,Southwest Airlines,MKE,ORD
SW360,1692502408,1692503344,936,13234,Southwest Airlines,ORD,MKE
SW360,1692517651,1692520599,2948,3803,Southwest Airlines,MKE,ORD
SW360,1692525856,1692527004,1148,6282,Southwest Airlines,ORD,MKE
SW360,1692543957,1692550402,6445,15364,Southwest Airlines,MKE,ORD
SW360,1692572535,1692573297,762,15320,Southwest Airlines,ORD,MKE
SW360,1692590427,1692592181,1754,12480,Southwest Airlines,MKE,SFO
SW360,1692605706,1692606606,900,15871,Southwest Airlines,SFO,LAX
SW360,1692628010,1692628427,417,15292,Southwest Airlines,LAX,SFO
SW360,1692652607,1692652836,229,9874,Southwest Airlines,SFO,LAX
SW360,1692663261,1692664975,1714,7197,Southwest Airlines,LAX,SFO
SW360,1692681306,1692682030,724,9619,Southwest Airlines,SFO,LAX
SW360,1692695974,1692696643,669,6984,Southwest Airlines,LAX,SFO
SW360,1692708906,1692710063,1157,8516,Southwest Airlines,SFO,LAX
SW360,1692724754,1692731160,6406,10046,Southwest Airlines,LAX,ORD
SW360,1692747950,1692749121,1171,15510,Southwest Airlines,ORD,MKE
SW360,1692772053,1692773465,1412,11177,Southwest Airlines,MKE,SFO
SW360,1692791500,1692801329,9829,5461,Southwest Airlines,SFO,ORD
SW360,1692808838,1692809074,236,20027,Southwest Airlines,ORD,MKE
SW360,1692832156,1692837767,5611,15646,Southwest Airlines,MKE,ORD
SW360,1692856603,1692857171,568,15677,Southwest Airlines,ORD,MKE
SW360,1692879769,1692885482,5713,19368,Southwest Airlines,MKE,ORD
SW360,1692912734,1692913140,406,8222,Southwest Airlines,ORD,MKE
SW360,1692923797,1692929081,5284,5288,Southwest Airlines,MKE,ORD
SW360,1692937203,1692938829,1626,13982,Southwest Airlines,ORD,MKE
SW360,1692958605,1692959040,435,20065,Southwest Airlines,MKE,SFO
SW360,1692988913,1692989005,92,12649,Southwest Airlines,SFO,LAX
SW360,1693012132,1693012692,560,11991,Southwest Airlines,LAX,SFO
SW360,1693027380,1693030868,3488,16862,Southwest Airlines,SFO,ORD
SW360,1693048021,1693048227,206,21581,Southwest Airlines,ORD,MKE
SW360,1693076893,1693078996,2103,4294,Southwest Airlines,MKE,ORD
SW360,1693091264,1693091849,585,20890,Southwest Airlines,ORD,MKE
SW360,1693113987,1693119823,5836,17682,Southwest Airlines,MKE,ORD
SW360,1693147836,1693149046,1210,17879,Southwest Airlines,ORD,MKE
SW360,1693173768,1693174696,928,4913,Southwest Airlines,MKE,LAX
SW360,1693188431,1693189702,1271,11534,Southwest Airlines,LAX,SFO
SW360,1693205850,1693205911,61,8017,Southwest Airlines,SFO,LAX
SW360,1693222191,1693222966,775,16309,Southwest Airlines,LAX,SFO
SW360,1693242871,1693244283,1412,6839,Southwest Airlines,SFO,LAX
SW360,1693254609,1693254707,98,21315,Southwest Airlines,LAX,SFO
SW360,1693284671,1693290865,6194,7573,Southwest Airlines,SFO,ORD
SW360,1693303513,1693304712,1199,18984,Southwest Airlines,ORD,MKE
SW360,1693328825,1693337314,8489,4156,Southwest Airlines,MKE,ORD
SW360,1693348157,1693348965,808,6234,Southwest Airlines,ORD,MKE
SW360,1693362519,1693363477,958,18191,Southwest Airlines,MKE,SFO
SW360,1693392327,1693392645,318,14918,Southwest Airlines,SFO,LAX
SW360,1693410848,1693411328,480,3746,Southwest Airlines,LAX,SFO
SW360,1693418067,1693418327,260,10319,Southwest Airlines,SFO,LAX
SW360,1693431241,1693442018,10777,16555,Southwest Airlines,LAX,ORD
SW360,1693460550,1693460630,80,9554,Southwest Airlines,ORD,MKE
SW360,1693479483,1693480892,1409,19511,Southwest Airlines,MKE,LAX
SW360,1693510034,1693518505,8471,10138,Southwest Airlines,LAX,ORD
SW360,1693537942,1693539075,1133,21194,Southwest Airlines,ORD,MKE
SW360,1693562155,1693565583,3428,11029,Southwest Airlines,MKE,ORD
SW360,1693583541,1693584747,1206,3907,Southwest Airlines,ORD,MKE
SW360,1693592951,1693598086,5135,8948,Southwest Airlines,MKE,ORD
SW360,1693613741,1693615263,1522,5872,Southwest Airlines,ORD,MKE
SW360,1693631633,1693633871,2238,13274,Southwest Airlines,MKE,ORD
SW360,1693653727,1693653773,46,15899,Southwest Airlines,ORD,MKE
SW360,1693680261,1693680964,703,19550,Southwest Airlines,MKE,LAX
SW360,1693706503,1693707145,642,15648,Southwest Airlines,LAX,SFO
SW360,1693732916,1693737990,5074,3798,Southwest Airlines,SFO,ORD
SW360,1693746015,1693747445,1430,11021,Southwest Airlines,ORD,MKE
SW360,1693762802,1693763150,348,16719,Southwest Airlines,MKE,LAX
SW360,1693789533,1693790894,1361,6557,Southwest Airlines,LAX,SFO
SW360,1693805155,1693815832,10677,17402,Southwest Airlines,SFO,ORD
SW360,1693837010,1693837147,137,13452,Southwest Airlines,ORD,MKE
SW360,1693856212,1693857482,1270,20409,Southwest Airlines,MKE,LAX
SW360,1693888545,1693898236,9691,8508,Southwest Airlines,LAX,ORD
SW360,1693907351,1693908741,1390,14506,Southwest Airlines,ORD,MKE
SW360,1693924661,1693933720,9059,15658,Southwest Airlines,MKE,ORD
SW360,1693959522,1693960364,842,11655,Southwest Airlines,ORD,MKE
SW360,1693977405,1693978105,700,19166,Southwest Airlines,MKE,LAX
SW360,1694003867,1694005256,1389,6350,Southwest Airlines,LAX,SFO
SW360,1694016974,1694017340,366,19835,Southwest Airlines,SFO,LAX
SW360,1694037787,1694039728,1941,5381,Southwest Airlines,LAX,ORD
SW360,1694048210,1694049888,1678,16518,Southwest Airlines,ORD,MKE
SW360,1694074072,1694075470,1398,17041,Southwest Airlines,MKE,SFO
SW360,1694095721,1694097273,1552,11410,Southwest Airlines,SFO,LAX
SW360,1694113531,1694114030,499,17256,Southwest Airlines,LAX,SFO
SW360,1694132756,1694141314,8558,14527,Southwest Airlines,SFO,ORD
SW360,1694166019,1694167439,1420,5860,Southwest Airlines,ORD,MKE
SW360,1694183134,1694183856,722,15990,Southwest Airlines,MKE,LAX
SW360,1694207060,1694214917,7857,7566,Southwest Airlines,LAX,ORD
SW360,1694233016,1694234108,1092,13328,Southwest Airlines,ORD,MKE
SW360,1694255345,1694256571,1226,20587,Southwest Airlines,MKE,LAX
SW360,1694287252,1694289623,2371,5562,Southwest Airlines,LAX,ORD
SW360,1694302199,1694302855,656,17689,Southwest Airlines,ORD,MKE
SW360,1694330906,1694337024,6118,8746,Southwest Airlines,MKE,ORD
SW360,1694354530,1694354779,249,14333,Southwest Airlines,ORD,MKE
SW360,1694369793,1694371482,1689,13682,Southwest Airlines,MKE,LAX
SW360,1694388196,1694391676,3480,14348,Southwest Airlines,LAX,ORD
SW360,1694409959,1694410475,516,19291,Southwest Airlines,ORD,MKE
SW360,1694438729,1694439991,1262,21319,Southwest Airlines,MKE,LAX
SW360,1694470936,1694472683,1747,10623,Southwest Airlines,LAX,SFO
SW360,1694493144,1694494245,1101,19104,Southwest Airlines,SFO,LAX
SW360,1694522039,1694522194,155,12860,Southwest Airlines,LAX,SFO
SW360,1694535761,1694541850,6089,15609,Southwest Airlines,SFO,ORD
SW360,1694567620,1694569233,1613,16155,Southwest Airlines,ORD,MKE
SW360,1694590583,1694591608,1025,7916,Southwest Airlines,MKE,LAX
SW360,1694604677,1694604696,19,20882,Southwest Airlines,LAX,SFO
SW360,1694634678,1694635705,1027,7694,Southwest Airlines,SFO,LAX
SW360,1694644973,1694646081,1108,4582,Southwest Airlines,LAX,SFO
SW360,1694659538,1694659720,182,20698,Southwest Airlines,SFO,LAX
SW360,1694689224,1694694998,5774,3726,Southwest Airlines,LAX,ORD
SW360,1694701323,1694702288,965,11974,Southwest Airlines,ORD,MKE
SW360,1694717446,1694718690,1244,20288,Southwest Airlines,MKE,LAX
SW360,1694742354,1694750691,8337,16528,Southwest Airlines,LAX,ORD
SW360,1694776518,1694778217,1699,12910,Southwest Airlines,ORD,MKE
SW360,1694793466,1694794838,1372,15047,Southwest Airlines,MKE,SFO
SW360,1694817466,1694819066,1600,14115,Southwest Airlines,SFO,LAX
SW360,1694839933,1694840009,76,10433,Southwest Airlines,LAX,SFO
SW360,1694857396,1694859151,1755,9792,Southwest Airlines,SFO,LAX
SW360,1694873572,1694879380,5808,15535,Southwest Airlines,LAX,ORD
SW360,1694903584,1694904906,1322,14029,Southwest Airlines,ORD,MKE
SW360,1694924802,1694926789,1987,15787,Southwest Airlines,MKE,ORD
SW360,1694942660,1694943915,1255,15491,Southwest Airlines,ORD,MKE
SW360,1694960624,1694961145,521,8277,Southwest Airlines,MKE,LAX
SW360,1694971088,1694971122,34,15116,Southwest Airlines,LAX,SFO
SW360,1694993522,1694998588,5066,21002,Southwest Airlines,SFO,ORD
SW360,1695029818,1695030322,504,5028,Southwest Airlines,ORD,MKE
SW360,1695042364,1695043737,1373,5684,Southwest Airlines,MKE,SFO
SW360,1695054589,1695061011,6422,3710,Southwest Airlines,SFO,ORD
SW360,1695068848,1695069335,487,18598,Southwest Airlines,ORD,MKE
SW360,1695097316,1695097374,58,17036,Southwest Airlines,MKE,LAX
SW360,1695117843,1695117939,96,13211,Southwest Airlines,LAX,SFO
SW360,1695131750,1695142205,10455,21029,Southwest Airlines,SFO,ORD
SW360,1695170760,1695171883,1123,3874,Southwest Airlines,ORD,MKE
SW360,1695178210,1695185011,6801,10762,Southwest Airlines,MKE,ORD
SW360,1695205881,1695206880,999,6087,Southwest Airlines,ORD,MKE
SW360,1695216867,1695217713,846,10211,Southwest Airlines,MKE,SFO
SW360,1695228522,1695236793,8271,14856,Southwest Airlines,SFO,ORD
SW360,1695261047,1695262493,1446,5095,Southwest Airlines,ORD,MKE
SW360,1695270952,1695272278,1326,7915,Southwest Airlines,MKE,LAX
SW360,1695281412,1695281788,376,7889,Southwest Airlines,LAX,SFO
SW360,1695295296,1695296975,1679,4433,Southwest Airlines,SFO,LAX
SW360,1695307235,1695315004,7769,4511,Southwest Airlines,LAX,ORD
SW360,1695326681,1695327069,388,7053,Southwest Airlines,ORD,MKE
SW360,1695335048,1695337789,2741,20059,Southwest Airlines,MKE,ORD
SW360,1695358486,1695360033,1547,6526,Southwest Airlines,ORD,MKE
SW360,1695371041,1695372136,1095,7070,Southwest Airlines,MKE,SFO
SW360,1695383906,1695391546,7640,14478,Southwest Airlines,SFO,ORD
SW360,1695411338,1695412074,736,7005,Southwest Airlines,ORD,MKE
SW360,1695424290,1695425306,1016,7253,Southwest Airlines,MKE,LAX
SW360,1695437382,1695447594,10212,21245,Southwest Airlines,LAX,ORD
SW360,1695469119,1695470199,1080,15904,Southwest Airlines,ORD,MKE
SW360,1695493709,1695495183,1474,11979,Southwest Airlines,MKE,LAX
SW360,1695514360,1695516252,1892,10568,Southwest Airlines,LAX,ORD
SW360,1695532467,1695532713,246,4088,Southwest Airlines,ORD,MKE
SW360,1695537132,1695537276,144,17415,Southwest Airlines,MKE,LAX
SW360,1695555451,1695557141,1690,12196,Southwest Airlines,LAX,SFO
SW360,1695576495,1695582205,5710,17921,Southwest Airlines,SFO,ORD
SW360,1695609881,1695611072,1191,4531,Southwest Airlines,ORD,MKE
SW360,1695616936,1695625483,8547,11119,Southwest Airlines,MKE,ORD
SW360,1695636669,1695637216,547,4065,Southwest Airlines,ORD,MKE
SW360,1695645490,1695646164,674,15113,Southwest Airlines,MKE,LAX
SW360,1695668751,1695668754,3,7422,Southwest Airlines,LAX,SFO
SW360,1695677049,1695678398,1349,20981,Southwest Airlines,SFO,LAX
SW360,1695702094,1695703052,958,19869,Southwest Airlines,LAX,SFO
SW360,1695731521,1695741815,10294,5445,Southwest Airlines,SFO,ORD
SW360,1695752840,1695753075,235,19520,Southwest Airlines,ORD,MKE
SW360,1695782975,1695784147,1172,12056,Southwest Airlines,MKE,LAX
SW360,1695805771,1695806272,501,8593,Southwest Airlines,LAX,SFO
SW360,1695818490,1695819031,541,10718,Southwest Airlines,SFO,LAX
SW360,1695839675,1695846126,6451,14469,Southwest Airlines,LAX,ORD
SW360,1695862394,1695863995,1601,18692,Southwest Airlines,ORD,MKE
SW360,1695892571,1695898463,5892,10067,Southwest Airlines,MKE,ORD
SW360,1695910112,1695910798,686,9982,Southwest Airlines,ORD,MKE
SW360,1695927324,1695927705,381,15421,Southwest Airlines,MKE,SFO
SW360,1695944770,1695946224,1454,15563,Southwest Airlines,SFO,LAX
SW360,1695962733,1695968645,5912,9932,Southwest Airlines,LAX,ORD
SW360,1695978580,1695979509,929,5689,Southwest Airlines,ORD,MKE
SW360,1695992437,1695993229,792,10637,Southwest Airlines,MKE,SFO
SW360,1696011053,1696013629,2576,16535,Southwest Airlines,SFO,ORD
SW360,1696039265,1696040360,1095,7274,Southwest Airlines,ORD,MKE
SW360,1696052100,1696052444,344,9627,Southwest Airlines,MKE,LAX
SW360,1696067796,1696077397,9601,10931,Southwest Airlines,LAX,ORD
SW360,1696088595,1696089339,744,18572,Southwest Airlines,ORD,MKE
SW360,1696111944,1696118020,6076,21221,Southwest Airlines,MKE,ORD
SW360,1696150032,1696151559,1527,9257,Southwest Airlines,ORD,MKE
SW360,1696165334,1696166123,789,13768,Southwest Airlines,MKE,SFO
SW360,1696181251,1696181386,135,4906,Southwest Airlines,SFO,LAX
SW360,1696186629,1696193675,7046,9309,Southwest Airlines,LAX,ORD
SW360,1696211226,1696212800,1574,9506,Southwest Airlines,ORD,MKE
SW360,1696230274,1696235037,4763,6104,Southwest Airlines,MKE,ORD
SW360,1696250506,1696252027,1521,10723,Southwest Airlines,ORD,MKE
SW360,1696267149,1696268541,1392,12960,Southwest Airlines,MKE,SFO
SW360,1696290098,1696299353,9255,8100,Southwest Airlines,SFO,ORD
SW360,1696314072,1696315008,936,3959,Southwest Airlines,ORD,MKE
SW360,1696322257,1696323597,1340,9887,Southwest Airlines,MKE,SFO
SW360,1696336029,1696340375,4346,3852,Southwest Airlines,SFO,ORD
SW360,1696352239,1696354029,1790,21580,Southwest Airlines,ORD,MKE
SW360,1696380112,1696380446,334,19753,Southwest Airlines,MKE,LAX
SW360,1696401071,1696402380,1309,14473,Southwest Airlines,LAX,SFO
SW360,1696421199,1696421718,519,11197,Southwest Airlines,SFO,LAX
SW360,1696433713,1696434514,801,8130,Southwest Airlines,LAX,SFO
SW360,1696447633,1696457294,9661,19923,Southwest Airlines,SFO,ORD
SW360,1696482121,1696483308,1187,21277,Southwest Airlines,ORD,MKE
SW360,1696506514,1696516931,10417,20178,Southwest Airlines,MKE,ORD
SW360,1696546830,1696548266,1436,4220,Southwest Airlines,ORD,MKE
SW360,1696555901,1696558300,2399,20120,Southwest Airlines,MKE,ORD
SW360,1696587078,1696588674,1596,21476,Southwest Airlines,ORD,MKE
SW360,1696616855,1696623170,6315,12668,Southwest Airlines,MKE,ORD
SW360,1696641359,1696642087,728,11394,Southwest Airlines,ORD,MKE
SW360,1696654811,1696656196,1385,13258,Southwest Airlines,MKE,SFO
SW360,1696673513,1696677095,3582,16892,Southwest Airlines,SFO,ORD
SW360,1696704017,1696704641,624,4133,Southwest Airlines,ORD,MKE
SW360,1696711558,1696713106,1548,13278,Southwest Airlines,MKE,SFO
SW360,1696736820,1696737234,414,7566,Southwest Airlines,SFO,LAX
SW360,1696746535,1696747625,1090,7995,Southwest Airlines,LAX,SFO
SW360,1696759014,1696759309,295,6224,Southwest Airlines,SFO,LAX
SW360,1696766793,1696767078,285,20558,Southwest Airlines,LAX,SFO
SW360,1696787684,1696787896,212,5628,Southwest Airlines,SFO,LAX
SW360,1696796198,1696797514,1316,13821,Southwest Airlines,LAX,SFO
SW360,1696815327,1696817538,2211,4550,Southwest Airlines,SFO,ORD
SW360,1696823905,1696824936,1031,9254,Southwest Airlines,ORD,MKE
SW360,1696834388,1696836042,1654,15724,Southwest Airlines,MKE,LAX
SW360,1696853432,1696855187,1755,5550,Southwest Airlines,LAX,SFO
SW360,1696870779,1696871807,1028,15901,Southwest Airlines,SFO,LAX
SW360,1696888574,1696890104,1530,7706,Southwest Airlines,LAX,SFO
SW360,1696903183,1696903967,784,12119,Southwest Airlines,SFO,LAX
SW360,1696922284,1696928180,5896,18781,Southwest Airlines,LAX,ORD
SW360,1696948722,1696949842,1120,14902,Southwest Airlines,ORD,MKE
SW360,1696966572,1696968309,1737,11505,Southwest Airlines,MKE,LAX
SW360,1696989279,1696993398,4119,8396,Southwest Airlines,LAX,ORD
SW360,1697006146,1697006942,796,8944,Southwest Airlines,ORD,MKE
SW360,1697021623,1697022005,382,14685,Southwest Airlines,MKE,SFO
SW360,1697041644,1697045040,3396,10794,Southwest Airlines,SFO,ORD
SW360,1697063067,1697063129,62,17423,Southwest Airlines,ORD,MKE
SW360,1697084032,1697086597,2565,10305,Southwest Airlines,MKE,ORD
SW360,1697102480,1697103104,624,9377,Southwest Airlines,ORD,MKE
SW360,1697118384,1697120124,1740,10719,Southwest Airlines,MKE,LAX
SW360,1697140302,1697146062,5760,3998,Southwest Airlines,LAX,ORD
SW360,1697154923,1697155249,326,14368,Southwest Airlines,ORD,MKE
SW360,1697172823,1697173617,794,20650,Southwest Airlines,MKE,LAX
SW360,1697194755,1697200990,6235,4634,Southwest Airlines,LAX,ORD
SW360,1697208464,1697209100,636,9154,Southwest Airlines,ORD,MKE
SW360,1697226071,1697231973,5902,9557,Southwest Airlines,MKE,ORD
SW360,1697242249,1697242304,55,14920,Southwest Airlines,ORD,MKE
SW360,1697263888,1697265267,1379,21168,Southwest Airlines,MKE,SFO
SW360,1697296431,1697297342,911,19876,Southwest Airlines,SFO,LAX
SW360,1697322120,1697322864,744,13992,Southwest Airlines,LAX,SFO
SW360,1697339938,1697345646,5708,19666,Southwest Airlines,SFO,ORD
SW360,1697369836,1697370809,973,6982,Southwest Airlines,ORD,MKE
SW360,1697386067,1697390333,4266,21205,Southwest Airlines,MKE,ORD
SW360,1697416613,1697417875,1262,17993,Southwest Airlines,ORD,MKE
SW360,1697441106,1697442729,1623,5926,Southwest Airlines,MKE,LAX
SW360,1697454886,1697457615,2729,17982,Southwest Airlines,LAX,ORD
SW360,1697482750,1697484150,1400,14462,Southwest Airlines,ORD,MKE
SW360,1697508593,1697509026,433,20836,Southwest Airlines,MKE,LAX
SW360,1697532010,1697535786,3776,8832,Southwest Airlines,LAX,ORD
SW360,1697548666,1697549704,1038,20289,Southwest Airlines,ORD,MKE
SW360,1697573946,1697576291,2345,19074,Southwest Airlines,MKE,ORD
SW360,1697603644,1697605029,1385,17925,Southwest Airlines,ORD,MKE
SW360,1697632027,1697633498,1471,15151,Southwest Airlines,MKE,LAX
SW360,1697652161,1697652314,153,9102,Southwest Airlines,LAX,SFO
SW360,1697666459,1697667777,1318,9608,Southwest Airlines,SFO,LAX
SW360,1697686251,1697687461,1210,11818,Southwest Airlines,LAX,SFO
SW360,1697707106,1697707284,178,5643,Southwest Airlines,SFO,LAX
SW360,1697717961,1697718116,155,14739,Southwest Airlines,LAX,SFO
SW360,1697735249,1697736876,1627,12642,Southwest Airlines,SFO,LAX
SW360,1697750129,1697751383,1254,17509,Southwest Airlines,LAX,SFO
SW360,1697771916,1697774336,2420,13583,Southwest Airlines,SFO,ORD
SW360,1697795180,1697796096,916,18365,Southwest Airlines,ORD,MKE
SW360,1697824672,1697825484,812,11262,Southwest Airlines,MKE,LAX
SW360,1697842946,1697843361,415,5356,Southwest Airlines,LAX,SFO
SW360,1697850231,1697851591,1360,17972,Southwest Airlines,SFO,LAX
SW360,1697871533,1697874026,2493,7909,Southwest Airlines,LAX,ORD
SW360,1697883200,1697884791,1591,12367,Southwest Airlines,ORD,MKE
SW360,1697900776,1697901224,448,5439,Southwest Airlines,MKE,SFO
SW360,1697907543,1697914354,6811,11717,Southwest Airlines,SFO,ORD
SW360,1697936281,1697937753,1472,3601,Southwest Airlines,ORD,MKE
SW360,1697949610,1697949953,343,16018,Southwest Airlines,MKE,SFO
SW360,1697975347,1697978491,3144,15621,Southwest Airlines,SFO,ORD
SW360,1697996696,1697997520,824,6668,Southwest Airlines,ORD,MKE
SW360,1698012704,1698012948,244,13798,Southwest Airlines,MKE,LAX
SW360,1698032319,1698033773,1454,4834,Southwest Airlines,LAX,SFO
SW360,1698042606,1698053030,10424,13465,Southwest Airlines,SFO,ORD
SW360,1698075542,1698076094,552,11685,Southwest Airlines,ORD,MKE
SW360,1698096176,1698104859,8683,10681,Southwest Airlines,MKE,ORD
SW360,1698119012,1698119727,715,3946,Southwest Airlines,ORD,MKE
SW360,1698127537,1698128665,1128,10032,Southwest Airlines,MKE,LAX
SW360,1698141347,1698144974,3627,7647,Southwest Airlines,LAX,ORD
SW360,1698161873,1698162719,846,12042,Southwest Airlines,ORD,MKE
SW360,1698180103,1698181399,1296,9970,Southwest Airlines,MKE,LAX
SW360,1698200876,1698211596,10720,4169,Southwest Airlines,LAX,ORD
SW360,1698222448,1698223657,1209,10213,Southwest Airlines,ORD,MKE
SW360,1698237851,1698238054,203,13778,Southwest Airlines,MKE,LAX
SW360,1698253891,1698261374,7483,5760,Southwest Airlines,LAX,ORD
SW360,1698273373,1698275146,1773,7321,Southwest Airlines,ORD,MKE
SW360,1698287659,1698297913,10254,9419,Southwest Airlines,MKE,ORD
SW360,1698316427,1698318031,1604,9256,Southwest Airlines,ORD,MKE
SW360,1698334465,1698344123,9658,14769,Southwest Airlines,MKE,ORD
SW360,1698367139,1698368764,1625,7189,Southwest Airlines,ORD,MKE
SW360,1698386148,1698386170,22,8522,Southwest Airlines,MKE,SFO
SW360,1698399976,1698401237,1261,19777,Southwest Airlines,SFO,LAX
SW360,1698426660,1698432242,5582,19497,Southwest Airlines,LAX,ORD
SW360,1698454318,1698454919,601,12945,Southwest Airlines,ORD,MKE
SW360,1698469346,1698469671,325,21035,Southwest Airlines,MKE,LAX
AA755,1682959659,1682968319,8660,18201,American Airlines,MKE,ORD
AA755,1682992824,1682994374,1550,14122,American Airlines,ORD,MKE
AA755,1683012503,1683013372,869,16259,American Airlines,MKE,SFO
AA755,1683038710,1683039832,1122,4757,American Airlines,SFO,LAX
AA755,1683052973,1683061555,8582,18548,American Airlines,LAX,ORD
AA755,1683082200,1683082779,579,6851,American Airlines,ORD,MKE
AA755,1683097119,1683097797,678,20410,American Airlines,MKE,LAX
AA755,1683120390,1683125058,4668,9043,American Airlines,LAX,ORD
AA755,1683135880,1683137311,1431,11111,American Airlines,ORD,MKE
AA755,1683149449,1683150400,951,7215,American Airlines,MKE,LAX
AA755,1683157855,1683168030,10175,14775,American Airlines,LAX,ORD
AA755,1683188476,1683189994,1518,17939,American Airlines,ORD,MKE
AA755,1683211893,1683212984,1091,5234,American Airlines,MKE,LAX
AA755,1683227946,1683228085,139,5874,American Airlines,LAX,SFO
AA755,1683240359,1683243192,2833,13225,American Airlines,SFO,ORD
AA755,1683257849,1683257914,65,17150,American Airlines,ORD,MKE
AA755,1683282677,1683284175,1498,14496,American Airlines,MKE,SFO
AA755,1683302142,1683304231,2089,9278,American Airlines,SFO,ORD
AA755,1683318441,1683318758,317,18506,American Airlines,ORD,MKE
AA755,1683347942,1683348188,246,5357,American Airlines,MKE,LAX
AA755,1683358185,1683359147,962,7175,American Airlines,LAX,SFO
AA755,1683368375,1683375875,7500,5089,American Airlines,SFO,ORD
AA755,1683390155,1683391278,1123,21130,American Airlines,ORD,MKE
AA755,1683413770,1683415484,1714,4310,American Airlines,MKE,SFO
AA755,1683424483,1683425364,881,4915,American Airlines,SFO,LAX
AA755,1683439104,1683439597,493,14482,American Airlines,LAX,SFO
AA755,1683459957,1683461024,1067,19242,American Airlines,SFO,LAX
AA755,1683483261,1683492110,8849,7614,American Airlines,LAX,ORD
AA755,1683507392,1683507464,72,8912,American Airlines,ORD,MKE
AA755,1683521126,1683527031,5905,20365,American Airlines,MKE,ORD
AA755,1683556772,1683557546,774,18559,American Airlines,ORD,MKE
AA755,1683579809,1683580986,1177,19970,American Airlines,MKE,SFO
AA755,1683606662,1683611413,4751,4525,American Airlines,SFO,ORD
AA755,1683617902,1683619514,1612,12468,American Airlines,ORD,MKE
AA755,1683636680,1683636733,53,20443,American Airlines,MKE,SFO
AA755,1683659937,1683660772,835,11623,American Airlines,SFO,LAX
AA755,1683677005,1683677608,603,19220,American Airlines,LAX,SFO
AA755,1683705736,1683707406,1670,8504,American Airlines,SFO,LAX
AA755,1683721354,1683721912,558,12757,American Airlines,LAX,SFO
AA755,1683743055,1683744588,1533,14233,American Airlines,SFO,LAX
AA755,1683762391,1683766898,4507,13235,American Airlines,LAX,ORD
AA755,1683784432,1683784959,527,9309,American Airlines,ORD,MKE
AA755,1683795593,1683798939,3346,12654,American Airlines,MKE,ORD
AA755,1683818370,1683819819,1449,9712,American Airlines,ORD,MKE
AA755,1683835095,1683840877,5782,18748,American Airlines,MKE,ORD
AA755,1683869083,1683870788,1705,14769,American Airlines,ORD,MKE
AA755,1683895267,1683902025,6758,5152,American Airlines,MKE,ORD
AA755,1683908406,1683909253,847,15048,American Airlines,ORD,MKE
AA755,1683931918,1683932305,387,18539,American Airlines,MKE,SFO
AA755,1683961145,1683961699,554,12943,American Airlines,SFO,LAX
AA755,1683975665,1683976540,875,16819,American Airlines,LAX,SFO
AA755,1683996903,1684003249,6346,4978,American Airlines,SFO,ORD
AA755,1684018442,1684018800,358,15526,American Airlines,ORD,MKE
AA755,1684041989,1684046638,4649,13817,American Airlines,MKE,ORD
AA755,1684068480,1684070114,1634,13812,American Airlines,ORD,MKE
AA755,1684088785,1684089396,611,20841,American Airlines,MKE,LAX
AA755,1684115189,1684116758,1569,19061,American Airlines,LAX,SFO
AA755,1684137730,1684137862,132,19159,American Airlines,SFO,LAX
AA755,1684164782,1684166076,1294,17739,American Airlines,LAX,SFO
AA755,1684192540,1684193207,667,12985,American Airlines,SFO,LAX
AA755,1684212215,1684213962,1747,12437,American Airlines,LAX,SFO
AA755,1684231342,1684231403,61,7261,American Airlines,SFO,LAX
AA755,1684242469,1684243853,1384,7931,American Airlines,LAX,SFO
AA755,1684256735,1684257747,1012,5841,American Airlines,SFO,LAX
AA755,1684264131,1684265286,1155,20548,American Airlines,LAX,SFO
AA755,1684293720,1684294272,552,8465,American Airlines,SFO,LAX
AA755,1684307498,1684311814,4316,7974,American Airlines,LAX,ORD
AA755,1684326989,1684328516,1527,6563,American Airlines,ORD,MKE
AA755,1684343743,1684347368,3625,20684,American Airlines,MKE,ORD
AA755,1684376638,1684377293,655,17461,American Airlines,ORD,MKE
AA755,1684403378,1684404134,756,9689,American Airlines,MKE,LAX
AA755,1684423150,1684423256,106,12822,American Airlines,LAX,SFO
AA755,1684440084,1684444146,4062,15689,American Airlines,SFO,ORD
AA755,1684469425,1684469977,552,7350,American Airlines,ORD,MKE
AA755,1684486132,1684486780,648,10992,American Airlines,MKE,LAX
AA755,1684504164,1684512207,8043,21583,American Airlines,LAX,ORD
AA755,1684534696,1684536074,1378,7172,American Airlines,ORD,MKE
AA755,1684551427,1684552090,663,12864,American Airlines,MKE,LAX
AA755,1684572691,1684572922,231,14019,American Airlines,LAX,SFO
AA755,1684588435,1684590475,2040,9030,American Airlines,SFO,ORD
AA755,1684602432,1684603565,1133,4429,American Airlines,ORD,MKE
AA755,1684617136,1684627366,10230,10024,American Airlines,MKE,ORD
AA755,1684641587,1684643344,1757,4670,American Airlines,ORD,MKE
AA755,1684654586,1684655658,1072,18025,American Airlines,MKE,LAX
AA755,1684680833,1684681625,792,14857,American Airlines,LAX,SFO
AA755,1684698280,1684698555,275,4498,American Airlines,SFO,LAX
AA755,1684711790,1684720273,8483,4666,American Airlines,LAX,ORD
AA755,1684732792,1684734076,1284,3827,American Airlines,ORD,MKE
AA755,1684744884,1684746912,2028,12625,American Airlines,MKE,ORD
AA755,1684769495,1684771054,1559,14134,American Airlines,ORD,MKE
AA755,1684787250,1684792671,5421,12629,American Airlines,MKE,ORD
AA755,1684809274,1684810494,1220,19237,American Airlines,ORD,MKE
AA755,1684831451,1684835080,3629,20339,American Airlines,MKE,ORD
AA755,1684864697,1684866486,1789,10571,American Airlines,ORD,MKE
AA755,1684881084,1684882570,1486,6783,American Airlines,MKE,LAX
AA755,1684891445,1684893276,1831,17352,American Airlines,LAX,ORD
AA755,1684920075,1684921665,1590,7196,American Airlines,ORD,MKE
AA755,1684939251,1684940613,1362,7878,American Airlines,MKE,SFO
AA755,1684952882,1684953520,638,9447,American Airlines,SFO,LAX
AA755,1684970930,1684971938,1008,7990,American Airlines,LAX,SFO
AA755,1684984260,1684988275,4015,4252,American Airlines,SFO,ORD
AA755,1684993027,1684994228,1201,12167,American Airlines,ORD,MKE
AA755,1685010412,1685012832,2420,9476,American Airlines,MKE,ORD
AA755,1685031802,1685032395,593,8706,American Airlines,ORD,MKE
AA755,1685042606,1685048168,5562,15338,American Airlines,MKE,ORD
AA755,1685070553,1685071303,750,20252,American Airlines,ORD,MKE
AA755,1685097406,1685099186,1780,10369,American Airlines,MKE,LAX
AA755,1685110946,1685111198,252,6390,American Airlines,LAX,SFO
AA755,1685121283,1685122758,1475,15268,American Airlines,SFO,LAX
AA755,1685144716,1685153798,9082,7166,American Airlines,LAX,ORD
AA755,1685164842,1685165601,759,9672,American Airlines,ORD,MKE
AA755,1685177560,1685185020,7460,5070,American Airlines,MKE,ORD
AA755,1685195564,1685196113,549,18821,American Airlines,ORD,MKE
AA755,1685224276,1685233501,9225,14698,American Airlines,MKE,ORD
AA755,1685249660,1685251416,1756,5107,American Airlines,ORD,MKE
AA755,1685264386,1685265545,1159,7156,American Airlines,MKE,SFO
AA755,1685281856,1685282352,496,18120,American Airlines,SFO,LAX
AA755,1685304896,1685306704,1808,21408,American Airlines,LAX,ORD
AA755,1685334324,1685334695,371,9101,American Airlines,ORD,MKE
AA755,1685345964,1685346088,124,21216,American Airlines,MKE,LAX
AA755,1685374308,1685376640,2332,7739,American Airlines,LAX,ORD
AA755,1685389358,1685390438,1080,7615,American Airlines,ORD,MKE
AA755,1685402043,1685403124,1081,9320,American Airlines,MKE,LAX
AA755,1685417093,1685417563,470,21283,American Airlines,LAX,SFO
AA755,1685444220,1685452010,7790,7796,American Airlines,SFO,ORD
AA755,1685470253,1685471649,1396,4432,American Airlines,ORD,MKE
AA755,1685481850,1685482629,779,8635,American Airlines,MKE,SFO
AA755,1685494800,1685501768,6968,12841,American Airlines,SFO,ORD
AA755,1685516717,1685518407,1690,9208,American Airlines,ORD,MKE
AA755,1685531217,1685532680,1463,7285,American Airlines,MKE,LAX
AA755,1685540795,1685540801,6,6409,American Airlines,LAX,SFO
AA755,1685550051,1685552675,2624,10662,American Airlines,SFO,ORD
AA755,1685569091,1685570438,1347,13218,American Airlines,ORD,MKE
AA755,1685591430,1685592962,1532,4482,American Airlines,MKE,LAX
AA755,1685604665,1685605697,1032,8078,American Airlines,LAX,SFO
AA755,1685618164,1685619899,1735,18032,American Airlines,SFO,LAX
AA755,1685641669,1685649048,7379,18029,American Airlines,LAX,ORD
AA755,1685676996,1685678038,1042,14166,American Airlines,ORD,MKE
AA755,1685701952,1685702107,155,18348,American Airlines,MKE,SFO
AA755,1685722400,1685723934,1534,19040,American Airlines,SFO,LAX
AA755,1685745287,1685753508,8221,16557,American Airlines,LAX,ORD
AA755,1685772771,1685773924,1153,20317,American Airlines,ORD,MKE
AA755,1685799719,1685801400,1681,7814,American Airlines,MKE,LAX
AA755,1685816672,1685820817,4145,9129,American Airlines,LAX,ORD
AA755,1685838977,1685839410,433,7999,American Airlines,ORD,MKE
AA755,1685857735,1685859191,1456,8787,American Airlines,MKE,SFO
AA755,1685870256,1685879639,9383,9268,American Airlines,SFO,ORD
AA755,1685892800,1685892983,183,6178,American Airlines,ORD,MKE
AA755,1685906405,1685907344,939,15413,American Airlines,MKE,SFO
AA755,1685926808,1685931327,4519,16989,American Airlines,SFO,ORD
AA755,1685957700,1685958992,1292,13500,American Airlines,ORD,MKE
AA755,1685979989,1685980748,759,15956,American Airlines,MKE,SFO
AA755,1685999708,1686000141,433,10287,American Airlines,SFO,LAX
AA755,1686011293,1686014391,3098,15153,American Airlines,LAX,ORD
AA755,1686034133,1686034546,413,3888,American Airlines,ORD,MKE
AA755,1686041956,1686043109,1153,21070,American Airlines,MKE,SFO
AA755,1686067014,1686068008,994,8371,American Airlines,SFO,LAX
AA755,1686079039,1686080318,1279,4946,American Airlines,LAX,SFO
AA755,1686094689,1686096540,1851,6903,American Airlines,SFO,ORD
AA755,1686111850,1686113460,1610,15041,American Airlines,ORD,MKE
AA755,1686137951,1686138387,436,18392,American Airlines,MKE,SFO
AA755,1686157762,1686165571,7809,15647,American Airlines,SFO,ORD
AA755,1686185677,1686186429,752,17603,American Airlines,ORD,MKE
AA755,1686213545,1686214566,1021,11674,American Airlines,MKE,LAX
AA755,1686231221,1686232508,1287,11166,American Airlines,LAX,SFO
AA755,1686244975,1686248013,3038,8845,American Airlines,SFO,ORD
AA755,1686259607,1686260635,1028,20134,American Airlines,ORD,MKE
AA755,1686284295,1686285409,1114,14554,American Airlines,MKE,LAX
AA755,1686305453,1686306287,834,20334,American Airlines,LAX,SFO
AA755,1686337112,1686337862,750,5347,American Airlines,SFO,LAX
AA755,1686352857,1686353776,919,4927,American Airlines,LAX,SFO
AA755,1686361901,1686365362,3461,4786,American Airlines,SFO,ORD
AA755,1686379973,1686381219,1246,4324,American Airlines,ORD,MKE
AA755,1686391407,1686401999,10592,7781,American Airlines,MKE,ORD
AA755,1686414262,1686414326,64,4634,American Airlines,ORD,MKE
AA755,1686420591,1686421238,647,8592,American Airlines,MKE,LAX
AA755,1686436566,1686444906,8340,13351,American Airlines,LAX,ORD
AA755,1686464024,1686465067,1043,8894,American Airlines,ORD,MKE
AA755,1686480139,1686488528,8389,10398,American Airlines,MKE,ORD
AA755,1686499288,1686500324,1036,10542,American Airlines,ORD,MKE
AA755,1686518694,1686519499,805,16773,American Airlines,MKE,LAX
AA755,1686542205,1686551915,9710,10110,American Airlines,LAX,ORD
AA755,1686564730,1686565755,1025,6328,American Airlines,ORD,MKE
AA755,1686577389,1686578294,905,19744,American Airlines,MKE,SFO
AA755,1686603785,1686603857,72,5367,American Airlines,SFO,LAX
AA755,1686612368,1686619600,7232,19194,American Airlines,LAX,ORD
AA755,1686646001,1686647200,1199,14568,American Airlines,ORD,MKE
AA755,1686670849,1686671000,151,20771,American Airlines,MKE,SFO
AA755,1686702266,1686705219,2953,3719,American Airlines,SFO,ORD
AA755,1686719182,1686720129,947,15451,American Airlines,ORD,MKE
AA755,1686744603,1686745295,692,5575,American Airlines,MKE,SFO
AA755,1686752963,1686763525,10562,7820,American Airlines,SFO,ORD
AA755,1686776437,1686777781,1344,11409,American Airlines,ORD,MKE
AA755,1686792712,1686794005,1293,16472,American Airlines,MKE,SFO
AA755,1686813829,1686814022,193,20492,American Airlines,SFO,LAX
AA755,1686838591,1686838756,165,15294,American Airlines,LAX,SFO
AA755,1686855364,1686856865,1501,15998,American Airlines,SFO,LAX
AA755,1686877808,1686879342,1534,10407,American Airlines,LAX,SFO
AA755,1686894082,1686894190,108,9306,American Airlines,SFO,LAX
AA755,1686910793,1686912149,1356,16184,American Airlines,LAX,SFO
AA755,1686931657,1686938184,6527,21527,American Airlines,SFO,ORD
AA755,1686967903,1686968943,1040,6545,American Airlines,ORD,MKE
AA755,1686977762,1686978059,297,7033,American Airlines,MKE,SFO
AA755,1686986252,1686991201,4949,10917,American Airlines,SFO,ORD
AA755,1687009292,1687010511,1219,20160,American Airlines,ORD,MKE
AA755,1687034773,1687035896,1123,4582,American Airlines,MKE,LAX
AA755,1687050359,1687059522,9163,10742,American Airlines,LAX,ORD
AA755,1687077641,1687077867,226,15420,American Airlines,ORD,MKE
AA755,1687097698,1687099485,1787,19617,American Airlines,MKE,LAX
AA755,1687123251,1687124298,1047,3647,American Airlines,LAX,SFO
AA755,1687128985,1687135335,6350,16304,American Airlines,SFO,ORD
AA755,1687152096,1687153841,1745,16339,American Airlines,ORD,MKE
AA755,1687178482,1687181272,2790,3976,American Airlines,MKE,ORD
AA755,1687187965,1687189022,1057,3983,American Airlines,ORD,MKE
AA755,1687196001,1687202355,6354,14061,American Airlines,MKE,ORD
AA755,1687221246,1687221327,81,16435,American Airlines,ORD,MKE
AA755,1687239460,1687242601,3141,19512,American Airlines,MKE,ORD
AA755,1687272413,1687272622,209,14773,American Airlines,ORD,MKE
AA755,1687296695,1687296995,300,10992,American Airlines,MKE,SFO
AA755,1687314267,1687315016,749,10530,American Airlines,SFO,LAX
AA755,1687325974,1687332641,6667,9354,American Airlines,LAX,ORD
AA755,1687346669,1687346990,321,16516,American Airlines,ORD,MKE
AA755,1687364259,1687366286,2027,14356,American Airlines,MKE,ORD
AA755,1687385429,1687386161,732,13611,American Airlines,ORD,MKE
AA755,1687399987,1687402193,2206,18373,American Airlines,MKE,ORD
AA755,1687428073,1687429846,1773,19131,American Airlines,ORD,MKE
AA755,1687455810,1687456308,498,6816,American Airlines,MKE,LAX
AA755,1687468781,1687478718,9937,6093,American Airlines,LAX,ORD
AA755,1687491446,1687492489,1043,6087,American Airlines,ORD,MKE
AA755,1687504515,1687508608,4093,6103,American Airlines,MKE,ORD
AA755,1687522516,1687523003,487,11037,American Airlines,ORD,MKE
AA755,1687537122,1687538960,1838,16562,American Airlines,MKE,ORD
AA755,1687560675,1687561928,1253,6077,American Airlines,ORD,MKE
AA755,1687578502,1687579636,1134,18311,American Airlines,MKE,SFO
AA755,1687605822,1687607497,1675,7785,American Airlines,SFO,LAX
AA755,1687622123,1687622558,435,17426,American Airlines,LAX,SFO
AA755,1687647260,1687654773,7513,18115,American Airlines,SFO,ORD
AA755,1687678622,1687680345,1723,21491,American Airlines,ORD,MKE
AA755,1687710581,1687712272,1691,18109,American Airlines,MKE,LAX
AA755,1687737636,1687738278,642,8532,American Airlines,LAX,SFO
AA755,1687750253,1687760239,9986,20505,American Airlines,SFO,ORD
AA755,1687781880,1687783252,1372,8628,American Airlines,ORD,MKE
AA755,1687795779,1687802739,6960,21095,American Airlines,MKE,ORD
AA755,1687827524,1687829091,1567,14864,American Airlines,ORD,MKE
AA755,1687844241,1687853126,8885,11690,American Airlines,MKE,ORD
AA755,1687869401,1687870099,698,12928,American Airlines,ORD,MKE
AA755,1687886806,1687887305,499,10289,American Airlines,MKE,SFO
AA755,1687905152,1687913503,8351,6638,American Airlines,SFO,ORD
AA755,1687922676,1687923570,894,8296,American Airlines,ORD,MKE
AA755,1687940049,1687945137,5088,6073,American Airlines,MKE,ORD
AA755,1687953098,1687953194,96,15354,American Airlines,ORD,MKE
AA755,1687975536,1687980472,4936,14836,American Airlines,MKE,ORD
AA755,1687996264,1687997060,796,4157,American Airlines,ORD,MKE
AA755,1688010298,1688010467,169,12086,American Airlines,MKE,LAX
AA755,1688029028,1688032180,3152,19501,American Airlines,LAX,ORD
AA755,1688058691,1688059278,587,7802,American Airlines,ORD,MKE
AA755,1688076872,1688077260,388,3620,American Airlines,MKE,LAX
AA755,1688085033,1688086415,1382,16267,American Airlines,LAX,SFO
AA755,1688107333,1688108363,1030,9795,American Airlines,SFO,LAX
AA755,1688124453,1688135099,10646,20887,American Airlines,LAX,ORD
AA755,1688156366,1688157589,1223,13321,American Airlines,ORD,MKE
AA755,1688180355,1688185329,4974,8318,American Airlines,MKE,ORD
AA755,1688201882,1688202450,568,4348,American Airlines,ORD,MKE
AA755,1688211199,1688218959,7760,9981,American Airlines,MKE,ORD
AA755,1688237828,1688238506,678,13042,American Airlines,ORD,MKE
AA755,1688262212,1688262561,349,20368,American Airlines,MKE,SFO
AA755,1688290321,1688296868,6547,19903,American Airlines,SFO,ORD
AA755,1688327353,1688328433,1080,6835,American Airlines,ORD,MKE
AA755,1688343032,1688345817,2785,11679,American Airlines,MKE,ORD
AA755,1688361110,1688362783,1673,18180,American Airlines,ORD,MKE
AA755,1688382255,1688391707,9452,9173,American Airlines,MKE,ORD
AA755,1688402189,1688402816,627,4495,American Airlines,ORD,MKE
AA755,1688411640,1688412987,1347,8046,American Airlines,MKE,SFO
AA755,1688422345,1688422513,168,16190,American Airlines,SFO,LAX
AA755,1688439106,1688440438,1332,15357,American Airlines,LAX,SFO
AA755,1688461804,1688467103,5299,6872,American Airlines,SFO,ORD
AA755,1688481774,1688482878,1104,9876,American Airlines,ORD,MKE
AA755,1688501042,1688501185,143,18246,American Airlines,MKE,LAX
AA755,1688525455,1688526736,1281,9278,American Airlines,LAX,SFO
AA755,1688546547,1688547136,589,17769,American Airlines,SFO,LAX
AA755,1688571486,1688572216,730,13606,American Airlines,LAX,SFO
AA755,1688587156,1688592616,5460,16863,American Airlines,SFO,ORD
AA755,1688613527,1688615132,1605,17437,American Airlines,ORD,MKE
AA755,1688635400,1688636210,810,4512,American Airlines,MKE,LAX
AA755,1688646009,1688651874,5865,7907,American Airlines,LAX,ORD
AA755,1688668664,1688670047,1383,7102,American Airlines,ORD,MKE
AA755,1688687641,1688691942,4301,21432,American Airlines,MKE,ORD
AA755,1688716555,1688717475,920,20775,American Airlines,ORD,MKE
AA755,1688747515,1688749228,1713,19439,American Airlines,MKE,LAX
AA755,1688772740,1688781620,8880,12122,American Airlines,LAX,ORD
AA755,1688795383,1688797153,1770,17589,American Airlines,ORD,MKE
AA755,1688818651,1688819758,1107,19114,American Airlines,MKE,LAX
AA755,1688849616,1688849724,108,7790,American Airlines,LAX,SFO
AA755,1688867786,1688877883,10097,14136,American Airlines,SFO,ORD
AA755,1688897239,1688898539,1300,7192,American Airlines,ORD,MKE
AA755,1688907909,1688914896,6987,13389,American Airlines,MKE,ORD
AA755,1688929552,1688930133,581,18503,American Airlines,ORD,MKE
AA755,1688953130,1688963420,10290,11806,American Airlines,MKE,ORD
AA755,1688976000,1688976406,406,8606,American Airlines,ORD,MKE
AA755,1688994257,1688995585,1328,18884,American Airlines,MKE,SFO
AA755,1689016514,1689016733,219,19909,American Airlines,SFO,LAX
AA755,1689041600,1689041626,26,8343,American Airlines,LAX,SFO
AA755,1689051127,1689056129,5002,20582,American Airlines,SFO,ORD
AA755,1689079095,1689079839,744,17998,American Airlines,ORD,MKE
AA755,1689103535,1689103911,376,16894,American Airlines,MKE,LAX
AA755,1689121129,1689124061,2932,11242,American Airlines,LAX,ORD
AA755,1689137673,1689137944,271,17515,American Airlines,ORD,MKE
AA755,1689156415,1689156852,437,8843,American Airlines,MKE,LAX
AA755,1689173173,1689182113,8940,6717,American Airlines,LAX,ORD
AA755,1689196201,1689197335,1134,5480,American Airlines,ORD,MKE
AA755,1689211748,1689212719,971,8344,American Airlines,MKE,SFO
AA755,1689226546,1689227680,1134,14419,American Airlines,SFO,LAX
AA755,1689244698,1689251283,6585,18606,American Airlines,LAX,ORD
AA755,1689277513,1689279161,1648,8544,American Airlines,ORD,MKE
AA755,1689290536,1689291739,1203,5180,American Airlines,MKE,SFO
AA755,1689297476,1689297953,477,8906,American Airlines,SFO,LAX
AA755,1689310704,1689316605,5901,16259,American Airlines,LAX,ORD
AA755,1689342208,1689343127,919,11856,American Airlines,ORD,MKE
AA755,1689360955,1689366314,5359,8921,American Airlines,MKE,ORD
AA755,1689381749,1689382370,621,12974,American Airlines,ORD,MKE
AA755,1689395377,1689396031,654,19946,American Airlines,MKE,SFO
AA755,1689423790,1689428775,4985,14251,American Airlines,SFO,ORD
AA755,1689446334,1689446693,359,7848,American Airlines,ORD,MKE
AA755,1689464281,1689465799,1518,7941,American Airlines,MKE,SFO
AA755,1689480452,1689480751,299,19133,American Airlines,SFO,LAX
AA755,1689506224,1689506840,616,15585,American Airlines,LAX,SFO
AA755,1689530969,1689538825,7856,10339,American Airlines,SFO,ORD
AA755,1689558626,1689559534,908,10553,American Airlines,ORD,MKE
AA755,1689574045,1689575583,1538,4507,American Airlines,MKE,LAX
AA755,1689585779,1689593065,7286,7988,American Airlines,LAX,ORD
AA755,1689608809,1689610559,1750,7393,American Airlines,ORD,MKE
AA755,1689626872,1689629672,2800,7105,American Airlines,MKE,ORD
AA755,1689642342,1689643513,1171,18359,American Airlines,ORD,MKE
AA755,1689666993,1689670209,3216,12380,American Airlines,MKE,ORD
AA755,1689684994,1689686194,1200,6714,American Airlines,ORD,MKE
AA755,1689696342,1689704232,7890,5738,American Airlines,MKE,ORD
AA755,1689718666,1689720048,1382,15533,American Airlines,ORD,MKE
AA755,1689739272,1689739577,305,6811,American Airlines,MKE,LAX
AA755,1689748266,1689749052,786,16196,American Airlines,LAX,SFO
AA755,1689769267,1689772573,3306,7885,American Airlines,SFO,ORD
AA755,1689783927,1689784415,488,5075,American Airlines,ORD,MKE
AA755,1689793472,1689794976,1504,11670,American Airlines,MKE,SFO
AA755,1689815924,1689816057,133,13219,American Airlines,SFO,LAX
AA755,1689837825,1689839579,1754,19259,American Airlines,LAX,SFO
AA755,1689861530,1689862101,571,15505,American Airlines,SFO,LAX
AA755,1689883956,1689885250,1294,12841,American Airlines,LAX,SFO
AA755,1689905495,1689905779,284,15289,American Airlines,SFO,LAX
AA755,1689927354,1689931409,4055,18405,American Airlines,LAX,ORD
AA755,1689954949,1689955380,431,9699,American Airlines,ORD,MKE
AA755,1689971269,1689971753,484,4724,American Airlines,MKE,SFO
AA755,1689979201,1689982937,3736,20093,American Airlines,SFO,ORD
AA755,1690012437,1690012865,428,4075,American Airlines,ORD,MKE
AA755,1690022064,1690027212,5148,15619,American Airlines,MKE,ORD
AA755,1690045185,1690046815,1630,8232,American Airlines,ORD,MKE
AA755,1690056392,1690058131,1739,9278,American Airlines,MKE,SFO
AA755,1690076603,1690077978,1375,4318,American Airlines,SFO,LAX
AA755,1690093053,1690099023,5970,9126,American Airlines,LAX,ORD
AA755,1690117704,1690118385,681,12498,American Airlines,ORD,MKE
AA755,1690132231,1690132454,223,17439,American Airlines,MKE,LAX
AA755,1690157567,1690158013,446,15959,American Airlines,LAX,SFO
AA755,1690179058,1690182498,3440,16867,American Airlines,SFO,ORD
AA755,1690208775,1690208921,146,8604,American Airlines,ORD,MKE
AA755,1690227234,1690228459,1225,14698,American Airlines,MKE,SFO
AA755,1690245418,1690248921,3503,21018,American Airlines,SFO,ORD
AA755,1690273623,1690275212,1589,10985,American Airlines,ORD,MKE
AA755,1690292145,1690293791,1646,14320,American Airlines,MKE,LAX
AA755,1690317573,1690322074,4501,19822,American Airlines,LAX,ORD
AA755,1690345052,1690345246,194,3803,American Airlines,ORD,MKE
AA755,1690354099,1690355257,1158,11148,American Airlines,MKE,SFO
AA755,1690375206,1690375591,385,6649,American Airlines,SFO,LAX
AA755,1690383946,1690393235,9289,13403,American Airlines,LAX,ORD
AA755,1690414287,1690414447,160,12470,American Airlines,ORD,MKE
AA755,1690427686,1690429455,1769,21563,American Airlines,MKE,SFO
AA755,1690458684,1690459103,419,9250,American Airlines,SFO,LAX
AA755,1690472653,1690472712,59,6845,American Airlines,LAX,SFO
AA755,1690483991,1690490481,6490,16027,American Airlines,SFO,ORD
AA755,1690510027,1690510102,75,3889,American Airlines,ORD,MKE
AA755,1690518713,1690519505,792,9075,American Airlines,MKE,SFO
AA755,1690529211,1690539395,10184,9788,American Airlines,SFO,ORD
AA755,1690554445,1690554487,42,14150,American Airlines,ORD,MKE
AA755,1690570056,1690570496,440,8220,American Airlines,MKE,SFO
AA755,1690587666,1690588045,379,8724,American Airlines,SFO,LAX
AA755,1690598251,1690599183,932,13865,American Airlines,LAX,SFO
AA755,1690623503,1690624829,1326,15196,American Airlines,SFO,LAX
AA755,1690646184,1690647828,1644,14080,American Airlines,LAX,SFO
AA755,1690667008,1690669210,2202,11822,American Airlines,SFO,ORD
AA755,1690682390,1690683620,1230,4028,American Airlines,ORD,MKE
AA755,1690688853,1690692310,3457,12933,American Airlines,MKE,ORD
AA755,1690715040,1690716630,1590,15477,American Airlines,ORD,MKE
AA755,1690740669,1690742312,1643,11618,American Airlines,MKE,SFO
AA755,1690759629,1690760635,1006,16798,American Airlines,SFO,LAX
AA755,1690778693,1690780481,1788,21475,American Airlines,LAX,SFO
AA755,1690805798,1690807750,1952,13650,American Airlines,SFO,ORD
AA755,1690825463,1690826406,943,19525,American Airlines,ORD,MKE
AA755,1690848882,1690850224,1342,8786,American Airlines,MKE,SFO
AA755,1690868661,1690876193,7532,12417,American Airlines,SFO,ORD
AA755,1690890791,1690891890,1099,20350,American Airlines,ORD,MKE
AA755,1690917287,1690918142,855,7685,American Airlines,MKE,LAX
AA755,1690926751,1690927155,404,16896,American Airlines,LAX,SFO
AA755,1690954414,1690954632,218,16559,American Airlines,SFO,LAX
AA755,1690973826,1690975373,1547,7696,American Airlines,LAX,SFO
AA755,1690986123,1690987758,1635,4457,American Airlines,SFO,LAX
AA755,1691001234,1691002012,778,10915,American Airlines,LAX,SFO
AA755,1691014839,1691019239,4400,20608,American Airlines,SFO,ORD
AA755,1691042465,1691044031,1566,19330,American Airlines,ORD,MKE
AA755,1691073245,1691073386,141,9840,American Airlines,MKE,SFO
AA755,1691090108,1691100758,10650,6796,American Airlines,SFO,ORD
AA755,1691116162,1691116485,323,3871,American Airlines,ORD,MKE
AA755,1691122216,1691122519,303,4680,American Airlines,MKE,LAX
AA755,1691132316,1691132777,461,14832,American Airlines,LAX,SFO
AA755,1691150886,1691156858,5972,9596,American Airlines,SFO,ORD
AA755,1691176064,1691176680,616,11330,American Airlines,ORD,MKE
AA755,1691194050,1691196584,2534,13945,American Airlines,MKE,ORD
AA755,1691215491,1691215491,0,16448,American Airlines,ORD,MKE
AA755,1691233088,1691233289,201,15726,American Airlines,MKE,LAX
AA755,1691252897,1691253104,207,18501,American Airlines,LAX,SFO
AA755,1691275803,1691277342,1539,5438,American Airlines,SFO,LAX
AA755,1691285673,1691292608,6935,17656,American Airlines,LAX,ORD
AA755,1691311954,1691312651,697,18281,American Airlines,ORD,MKE
AA755,1691333320,1691334751,1431,4611,American Airlines,MKE,SFO
AA755,1691340638,1691350529,9891,6761,American Airlines,SFO,ORD
AA755,1691367766,1691368547,781,15962,American Airlines,ORD,MKE
AA755,1691389841,1691390369,528,4520,American Airlines,MKE,SFO
AA755,1691403449,1691404351,902,8165,American Airlines,SFO,LAX
AA755,1691417016,1691417839,823,17113,American Airlines,LAX,SFO
AA755,1691442747,1691444394,1647,11015,American Airlines,SFO,LAX
AA755,1691462390,1691462582,192,16040,American Airlines,LAX,SFO
AA755,1691488749,1691499165,10416,20992,American Airlines,SFO,ORD
AA755,1691523169,1691524896,1727,8744,American Airlines,ORD,MKE
AA755,1691541722,1691546224,4502,4179,American Airlines,MKE,ORD
AA755,1691556967,1691557229,262,3684,American Airlines,ORD,MKE
AA755,1691565469,1691566195,726,19444,American Airlines,MKE,SFO
AA755,1691585761,1691596469,10708,15638,American Airlines,SFO,ORD
AA755,1691615950,1691616387,437,17473,American Airlines,ORD,MKE
AA755,1691637217,1691638756,1539,13477,American Airlines,MKE,LAX
AA755,1691657602,1691657880,278,17424,American Airlines,LAX,SFO
AA755,1691681941,1691686101,4160,7686,American Airlines,SFO,ORD
AA755,1691699782,1691701577,1795,4957,American Airlines,ORD,MKE
AA755,1691712591,1691714313,1722,20514,American Airlines,MKE,SFO
AA755,1691741023,1691751118,10095,5280,American Airlines,SFO,ORD
AA755,1691761434,1691761625,191,9332,American Airlines,ORD,MKE
AA755,1691775491,1691778640,3149,16569,American Airlines,MKE,ORD
AA755,1691798456,1691800172,1716,5844,American Airlines,ORD,MKE
AA755,1691813495,1691814408,913,18700,American Airlines,MKE,LAX
AA755,1691842560,1691843071,511,13009,American Airlines,LAX,SFO
AA755,1691860641,1691861593,952,20397,American Airlines,SFO,LAX
AA755,1691889596,1691891183,1587,16812,American Airlines,LAX,SFO
AA755,1691909329,1691911678,2349,5255,American Airlines,SFO,ORD
AA755,1691920350,1691920742,392,5840,American Airlines,ORD,MKE
AA755,1691934011,1691944092,10081,4709,American Airlines,MKE,ORD
AA755,1691956610,1691957466,856,9732,American Airlines,ORD,MKE
AA755,1691969106,1691970695,1589,15800,American Airlines,MKE,SFO
AA755,1691996067,1692006319,10252,3933,American Airlines,SFO,ORD
AA755,1692011623,1692012226,603,11608,American Airlines,ORD,MKE
AA755,1692030197,1692031771,1574,6352,American Airlines,MKE,SFO
AA755,1692043713,1692052057,8344,9594,American Airlines,SFO,ORD
AA755,1692064116,1692065524,1408,18621,American Airlines,ORD,MKE
AA755,1692089370,1692090981,1611,9411,American Airlines,MKE,SFO
AA755,1692109170,1692118159,8989,3892,American Airlines,SFO,ORD
AA755,1692123393,1692124998,1605,6233,American Airlines,ORD,MKE
AA755,1692132425,1692134751,2326,21354,American Airlines,MKE,ORD
AA755,1692165621,1692166151,530,17015,American Airlines,ORD,MKE
AA755,1692184245,1692189779,5534,7159,American Airlines,MKE,ORD
AA755,1692201293,1692201986,693,8726,American Airlines,ORD,MKE
AA755,1692221331,1692221384,53,11497,American Airlines,MKE,LAX
AA755,1692234289,1692235134,845,18542,American Airlines,LAX,SFO
AA755,1692263817,1692267855,4038,17678,American Airlines,SFO,ORD
AA755,1692286955,1692288028,1073,13168,American Airlines,ORD,MKE
AA755,1692310123,1692311102,979,20546,American Airlines,MKE,LAX
AA755,1692338630,1692339572,942,21482,American Airlines,LAX,SFO
AA755,1692369333,1692369855,522,6039,American Airlines,SFO,LAX
AA755,1692381728,1692389919,8191,15708,American Airlines,LAX,ORD
AA755,1692414553,1692415178,625,17494,American Airlines,ORD,MKE
AA755,1692433552,1692433834,282,18282,American Airlines,MKE,LAX
AA755,1692462511,1692465454,2943,14621,American Airlines,LAX,ORD
AA755,1692484850,1692485668,818,20167,American Airlines,ORD,MKE
AA755,1692508627,1692508892,265,14668,American Airlines,MKE,SFO
AA755,1692524499,1692526190,1691,9615,American Airlines,SFO,LAX
AA755,1692541821,1692541860,39,17775,American Airlines,LAX,SFO
AA755,1692559674,1692561375,1701,12661,American Airlines,SFO,LAX
AA755,1692575912,1692576882,970,12525,American Airlines,LAX,SFO
AA755,1692594690,1692601080,6390,11141,American Airlines,SFO,ORD
AA755,1692614498,1692615712,1214,16484,American Airlines,ORD,MKE
AA755,1692637615,1692637626,11,9652,American Airlines,MKE,LAX
AA755,1692649780,1692658627,8847,10920,American Airlines,LAX,ORD
AA755,1692679535,1692680628,1093,4602,American Airlines,ORD,MKE
AA755,1692690857,1692691092,235,13094,American Airlines,MKE,LAX
AA755,1692711981,1692713660,1679,11868,American Airlines,LAX,SFO
AA755,1692726544,1692726559,15,11154,American Airlines,SFO,LAX
AA755,1692744700,1692747474,2774,10860,American Airlines,LAX,ORD
AA755,1692761072,1692762669,1597,21353,American Airlines,ORD,MKE
AA755,1692790967,1692792757,1790,17783,American Airlines,MKE,LAX
AA755,1692818147,1692828882,10735,3977,American Airlines,LAX,ORD
AA755,1692836875,1692837862,987,20502,American Airlines,ORD,MKE
AA755,1692861561,1692862489,928,11212,American Airlines,MKE,SFO
AA755,1692883624,1692889138,5514,15153,American Airlines,SFO,ORD
AA755,1692912765,1692913459,694,13164,American Airlines,ORD,MKE
AA755,1692927923,1692930975,3052,5669,American Airlines,MKE,ORD
AA755,1692941562,1692942383,821,4193,American Airlines,ORD,MKE
AA755,1692953446,1692953962,516,6536,American Airlines,MKE,LAX
AA755,1692968397,1692978385,9988,13447,American Airlines,LAX,ORD
AA755,1692998951,1693000496,1545,18940,American Airlines,ORD,MKE
AA755,1693022507,1693024194,1687,20034,American Airlines,MKE,LAX
AA755,1693047575,1693047947,372,11504,American Airlines,LAX,SFO
AA755,1693066907,1693068110,1203,17977,American Airlines,SFO,LAX
AA755,1693094935,1693095312,377,3797,American Airlines,LAX,SFO
AA755,1693101399,1693108730,7331,14584,American Airlines,SFO,ORD
AA755,1693132998,1693133648,650,10088,American Airlines,ORD,MKE
AA755,1693152939,1693157229,4290,20801,American Airlines,MKE,ORD
AA755,1693180003,1693181711,1708,16096,American Airlines,ORD,MKE
AA755,1693199004,1693200518,1514,6507,American Airlines,MKE,LAX
AA755,1693211383,1693213737,2354,9159,American Airlines,LAX,ORD
AA755,1693232869,1693233600,731,19653,American Airlines,ORD,MKE
AA755,1693257280,1693266769,9489,11299,American Airlines,MKE,ORD
AA755,1693285215,1693285942,727,18638,American Airlines,ORD,MKE
AA755,1693312356,1693320850,8494,18925,American Airlines,MKE,ORD
AA755,1693348752,1693349866,1114,10355,American Airlines,ORD,MKE
AA755,1693364539,1693365840,1301,16739,American Airlines,MKE,LAX
AA755,1693390926,1693399178,8252,19229,American Airlines,LAX,ORD
AA755,1693426045,1693426901,856,5746,American Airlines,ORD,MKE
AA755,1693436999,1693445597,8598,14305,American Airlines,MKE,ORD
AA755,1693467838,1693467959,121,12700,American Airlines,ORD,MKE
AA755,1693490882,1693492491,1609,6323,American Airlines,MKE,SFO
AA755,1693505043,1693514138,9095,11477,American Airlines,SFO,ORD
AA755,1693535903,1693535916,13,17329,American Airlines,ORD,MKE
AA755,1693555073,1693561344,6271,19351,American Airlines,MKE,ORD
AA755,1693589379,1693590275,896,21224,American Airlines,ORD,MKE
AA755,1693616697,1693618175,1478,17438,American Airlines,MKE,SFO
AA755,1693640373,1693641794,1421,19167,American Airlines,SFO,LAX
AA755,1693667722,1693676165,8443,19082,American Airlines,LAX,ORD
AA755,1693696830,1693697721,891,15744,American Airlines,ORD,MKE
AA755,1693724044,1693730099,6055,12994,American Airlines,MKE,ORD
AA755,1693744196,1693745413,1217,14514,American Airlines,ORD,MKE
AA755,1693769565,1693776895,7330,12619,American Airlines,MKE,ORD
AA755,1693790326,1693791391,1065,9461,American Airlines,ORD,MKE
AA755,1693804907,1693808936,4029,12079,American Airlines,MKE,ORD
AA755,1693830767,1693831007,240,15111,American Airlines,ORD,MKE
AA755,1693854682,1693856312,1630,3831,American Airlines,MKE,LAX
AA755,1693861759,1693865973,4214,8712,American Airlines,LAX,ORD
AA755,1693877181,1693877916,735,13665,American Airlines,ORD,MKE
AA755,1693897841,1693900155,2314,20862,American Airlines,MKE,ORD
AA755,1693923407,1693923761,354,9317,American Airlines,ORD,MKE
AA755,1693933470,1693942065,8595,17083,American Airlines,MKE,ORD
AA755,1693964687,1693965162,475,20190,American Airlines,ORD,MKE
AA755,1693989408,1693994508,5100,7302,American Airlines,MKE,ORD
AA755,1694005272,1694006752,1480,19499,American Airlines,ORD,MKE
AA755,1694029631,1694030616,985,8634,American Airlines,MKE,SFO
AA755,1694045559,1694047019,1460,17215,American Airlines,SFO,LAX
AA755,1694073108,1694082138,9030,15520,American Airlines,LAX,ORD
AA755,1694106353,1694107732,1379,10273,American Airlines,ORD,MKE
AA755,1694119224,1694126504,7280,5719,American Airlines,MKE,ORD
AA755,1694137066,1694137994,928,21352,American Airlines,ORD,MKE
AA755,1694165488,1694173745,8257,17122,American Airlines,MKE,ORD
AA755,1694194245,1694195944,1699,9775,American Airlines,ORD,MKE
AA755,1694206196,1694207769,1573,3693,American Airlines,MKE,SFO
AA755,1694219390,1694221152,1762,18776,American Airlines,SFO,LAX
AA755,1694248687,1694249658,971,21351,American Airlines,LAX,SFO
AA755,1694280435,1694281721,1286,4791,American Airlines,SFO,LAX
AA755,1694290867,1694295468,4601,11015,American Airlines,LAX,ORD
AA755,1694309385,1694309629,244,21193,American Airlines,ORD,MKE
AA755,1694334457,1694336108,1651,18524,American Airlines,MKE,LAX
AA755,1694355689,1694356794,1105,21194,American Airlines,LAX,SFO
AA755,1694388637,1694395989,7352,11746,American Airlines,SFO,ORD
AA755,1694410124,1694411636,1512,14433,American Airlines,ORD,MKE
AA755,1694430505,1694431931,1426,5214,American Airlines,MKE,LAX
AA755,1694441314,1694448528,7214,8511,American Airlines,LAX,ORD
AA755,1694464465,1694465558,1093,10550,American Airlines,ORD,MKE
AA755,1694486009,1694487274,1265,4667,American Airlines,MKE,LAX
AA755,1694502504,1694502567,63,10398,American Airlines,LAX,SFO
AA755,1694521909,1694532394,10485,14812,American Airlines,SFO,ORD
AA755,1694556832,1694558058,1226,13448,American Airlines,ORD,MKE
AA755,1694578787,1694586515,7728,8280,American Airlines,MKE,ORD
AA755,1694599357,1694600597,1240,8746,American Airlines,ORD,MKE
AA755,1694611876,1694612355,479,16642,American Airlines,MKE,LAX
AA755,1694630359,1694640568,10209,18007,American Airlines,LAX,ORD
AA755,1694664816,1694665425,609,13510,American Airlines,ORD,MKE
AA755,1694684386,1694685384,998,16742,American Airlines,MKE,SFO
AA755,1694706836,1694707314,478,17603,American Airlines,SFO,LAX
AA755,1694728388,1694738177,9789,13967,American Airlines,LAX,ORD
AA755,1694757234,1694758618,1384,6959,American Airlines,ORD,MKE
AA755,1694776054,1694777054,1000,20973,American Airlines,MKE,LAX
AA755,1694808488,1694809105,617,19416,American Airlines,LAX,SFO
AA755,1694829385,1694833618,4233,7024,American Airlines,SFO,ORD
AA755,1694843596,1694844015,419,6387,American Airlines,ORD,MKE
AA755,1694851780,1694853381,1601,9384,American Airlines,MKE,SFO
AA755,1694869629,1694880124,10495,20949,American Airlines,SFO,ORD
AA755,1694910933,1694911218,285,12422,American Airlines,ORD,MKE
AA755,1694934305,1694935122,817,20440,American Airlines,MKE,SFO
AA755,1694962151,1694966508,4357,17866,American Airlines,SFO,ORD
AA755,1694990416,1694990851,435,19525,American Airlines,ORD,MKE
AA755,1695016335,1695017287,952,12120,American Airlines,MKE,SFO
AA755,1695037062,1695040110,3048,5362,American Airlines,SFO,ORD
AA755,1695046599,1695047963,1364,7219,American Airlines,ORD,MKE
AA755,1695061762,1695062407,645,14222,American Airlines,MKE,LAX
AA755,1695078552,1695079712,1160,7190,American Airlines,LAX,SFO
AA755,1695089846,1695096651,6805,9573,American Airlines,SFO,ORD
AA755,1695108059,1695108838,779,5134,American Airlines,ORD,MKE
AA755,1695123904,1695124270,366,12531,American Airlines,MKE,SFO
AA755,1695146152,1695156541,10389,17400,American Airlines,SFO,ORD
AA755,1695175538,1695177091,1553,6213,American Airlines,ORD,MKE
AA755,1695190113,1695190147,34,17957,American Airlines,MKE,LAX
AA755,1695214919,1695220571,5652,14735,American Airlines,LAX,ORD
AA755,1695239319,1695239939,620,4092,American Airlines,ORD,MKE
AA755,1695254315,1695258182,3867,17883,American Airlines,MKE,ORD
AA755,1695279284,1695280978,1694,6505,American Airlines,ORD,MKE
AA755,1695294985,1695295814,829,4304,American Airlines,MKE,LAX
AA755,1695304692,1695307917,3225,17120,American Airlines,LAX,ORD
AA755,1695331409,1695331558,149,7501,American Airlines,ORD,MKE
AA755,1695346586,1695348025,1439,7985,American Airlines,MKE,LAX
AA755,1695356649,1695357966,1317,11432,American Airlines,LAX,SFO
AA755,1695376082,1695377521,1439,5646,American Airlines,SFO,LAX
AA755,1695391087,1695392164,1077,18400,American Airlines,LAX,SFO
AA755,1695418178,1695425600,7422,4081,American Airlines,SFO,ORD
AA755,1695437229,1695437362,133,8729,American Airlines,ORD,MKE
AA755,1695451038,1695452712,1674,18741,American Airlines,MKE,LAX
AA755,1695471784,1695480846,9062,11821,American Airlines,LAX,ORD
AA755,1695501242,1695501744,502,19985,American Airlines,ORD,MKE
AA755,1695528509,1695530176,1667,8987,American Airlines,MKE,SFO
AA755,1695543293,1695547524,4231,7680,American Airlines,SFO,ORD
AA755,1695557367,1695557793,426,15741,American Airlines,ORD,MKE
AA755,1695583801,1695583920,119,12943,American Airlines,MKE,LAX
AA755,1695602066,1695612851,10785,4790,American Airlines,LAX,ORD
AA755,1695623367,1695624185,818,5516,American Airlines,ORD,MKE
AA755,1695632244,1695637565,5321,9900,American Airlines,MKE,ORD
AA755,1695648905,1695649236,331,17687,American Airlines,ORD,MKE
AA755,1695668083,1695673637,5554,15077,American Airlines,MKE,ORD
AA755,1695698792,1695698832,40,19546,American Airlines,ORD,MKE
AA755,1695728388,1695729469,1081,10156,American Airlines,MKE,SFO
AA755,1695743943,1695748900,4957,15246,American Airlines,SFO,ORD
AA755,1695774242,1695774938,696,8958,American Airlines,ORD,MKE
AA755,1695792180,1695799447,7267,6669,American Airlines,MKE,ORD
AA755,1695811926,1695812027,101,14454,American Airlines,ORD,MKE
AA755,1695828667,1695829962,1295,13709,American Airlines,MKE,LAX
AA755,1695846132,1695855186,9054,15537,American Airlines,LAX,ORD
AA755,1695879319,1695880986,1667,4152,American Airlines,ORD,MKE
AA755,1695895575,1695896893,1318,20495,American Airlines,MKE,SFO
AA755,1695921884,1695929613,7729,16636,American Airlines,SFO,ORD
AA755,1695955530,1695956577,1047,11089,American Airlines,ORD,MKE
AA755,1695976937,1695979937,3000,3918,American Airlines,MKE,ORD
AA755,1695985257,1695985656,399,4684,American Airlines,ORD,MKE
AA755,1695996235,1695997088,853,14615,American Airlines,MKE,LAX
AA755,1696018016,1696018817,801,17180,American Airlines,LAX,SFO
AA755,1696038692,1696039320,628,19630,American Airlines,SFO,LAX
AA755,1696061568,1696061877,309,18526,American Airlines,LAX,SFO
AA755,1696085751,1696085759,8,8310,American Airlines,SFO,LAX
AA755,1696104780,1696105432,652,20405,American Airlines,LAX,SFO
AA755,1696126622,1696129676,3054,4320,American Airlines,SFO,ORD
AA755,1696138404,1696138485,81,10968,American Airlines,ORD,MKE
AA755,1696154466,1696157050,2584,6211,American Airlines,MKE,ORD
AA755,1696166019,1696167223,1204,19796,American Airlines,ORD,MKE
AA755,1696194691,1696202166,7475,20935,American Airlines,MKE,ORD
AA755,1696229725,1696230407,682,9616,American Airlines,ORD,MKE
AA755,1696240385,1696241624,1239,10035,American Airlines,MKE,SFO
AA755,1696252706,1696262310,9604,5709,American Airlines,SFO,ORD
AA755,1696269013,1696269156,143,5054,American Airlines,ORD,MKE
AA755,1696282558,1696283717,1159,14650,American Airlines,MKE,SFO
AA755,1696302994,1696304981,1987,10610,American Airlines,SFO,ORD
AA755,1696324441,1696324714,273,19020,American Airlines,ORD,MKE
AA755,1696347496,1696348344,848,19592,American Airlines,MKE,SFO
AA755,1696375308,1696381586,6278,12906,American Airlines,SFO,ORD
AA755,1696396421,1696397532,1111,15130,American Airlines,ORD,MKE
AA755,1696422188,1696426552,4364,18328,American Airlines,MKE,ORD
AA755,1696447211,1696447442,231,6453,American Airlines,ORD,MKE
AA755,1696462151,1696465141,2990,5688,American Airlines,MKE,ORD
AA755,1696475163,1696475831,668,9566,American Airlines,ORD,MKE
AA755,1696488905,1696490095,1190,6422,American Airlines,MKE,SFO
AA755,1696500792,1696501766,974,5951,American Airlines,SFO,LAX
AA755,1696516023,1696521790,5767,12302,American Airlines,LAX,ORD
AA755,1696543337,1696544577,1240,18057,American Airlines,ORD,MKE
AA755,1696572708,1696573564,856,16468,American Airlines,MKE,SFO
AA755,1696600476,1696603895,3419,8251,American Airlines,SFO,ORD
AA755,1696617117,1696617186,69,8034,American Airlines,ORD,MKE
AA755,1696627795,1696632543,4748,16554,American Airlines,MKE,ORD
AA755,1696655380,1696655651,271,18824,American Airlines,ORD,MKE
AA755,1696679607,1696680454,847,11714,American Airlines,MKE,SFO
AA755,1696699726,1696703932,4206,10324,American Airlines,SFO,ORD
AA755,1696720978,1696721271,293,16052,American Airlines,ORD,MKE
AA755,1696743177,1696743615,438,10754,American Airlines,MKE,SFO
AA755,1696755787,1696757765,1978,17341,American Airlines,SFO,ORD
AA755,1696785122,1696786619,1497,5811,American Airlines,ORD,MKE
AA755,1696795153,1696796248,1095,16982,American Airlines,MKE,LAX
AA755,1696821766,1696822968,1202,12923,American Airlines,LAX,SFO
AA755,1696836608,1696843694,7086,19143,American Airlines,SFO,ORD
AA755,1696870750,1696871162,412,8148,American Airlines,ORD,MKE
AA755,1696884642,1696892053,7411,4778,American Airlines,MKE,ORD
AA755,1696907393,1696908697,1304,16781,American Airlines,ORD,MKE
AA755,1696930085,1696938613,8528,14726,American Airlines,MKE,ORD
AA755,1696961092,1696962736,1644,14287,American Airlines,ORD,MKE
AA755,1696987586,1696988198,612,21026,American Airlines,MKE,SFO
AA755,1697016971,1697017928,957,7727,American Airlines,SFO,LAX
AA755,1697026672,1697027032,360,17827,American Airlines,LAX,SFO
AA755,1697052913,1697053054,141,6757,American Airlines,SFO,LAX
AA755,1697062163,1697062834,671,16973,American Airlines,LAX,SFO
AA755,1697082298,1697088224,5926,19756,American Airlines,SFO,ORD
AA755,1697108520,1697109985,1465,16593,American Airlines,ORD,MKE
AA755,1697133470,1697134578,1108,6615,American Airlines,MKE,SFO
AA755,1697150826,1697152407,1581,19550,American Airlines,SFO,LAX
AA755,1697179949,1697180241,292,4610,American Airlines,LAX,SFO
AA755,1697187800,1697188438,638,11418,American Airlines,SFO,LAX
AA755,1697209768,1697210407,639,16566,American Airlines,LAX,SFO
AA755,1697227306,1697235376,8070,7561,American Airlines,SFO,ORD
AA755,1697243855,1697244583,728,3873,American Airlines,ORD,MKE
AA755,1697253420,1697256700,3280,16757,American Airlines,MKE,ORD
AA755,1697282731,1697283397,666,5130,American Airlines,ORD,MKE
AA755,1697288791,1697289868,1077,18143,American Airlines,MKE,LAX
AA755,1697310575,1697313282,2707,20490,American Airlines,LAX,ORD
AA755,1697337649,1697339420,1771,14992,American Airlines,ORD,MKE
AA755,1697356224,1697357144,920,16787,American Airlines,MKE,SFO
AA755,1697379793,1697387245,7452,13613,American Airlines,SFO,ORD
AA755,1697402337,1697403288,951,18212,American Airlines,ORD,MKE
AA755,1697431571,1697431747,176,14868,American Airlines,MKE,SFO
AA755,1697446750,1697453741,6991,12011,American Airlines,SFO,ORD
AA755,1697467159,1697467938,779,20923,American Airlines,ORD,MKE
AA755,1697499233,1697499831,598,9486,American Airlines,MKE,SFO
AA755,1697515448,1697515533,85,20802,American Airlines,SFO,LAX
AA755,1697546585,1697546776,191,12267,American Airlines,LAX,SFO
AA755,1697567917,1697569143,1226,18035,American Airlines,SFO,LAX
AA755,1697592833,1697593216,383,15690,American Airlines,LAX,SFO
AA755,1697611791,1697613027,1236,13505,American Airlines,SFO,LAX
AA755,1697629665,1697630005,340,4577,American Airlines,LAX,SFO
AA755,1697644978,1697645350,372,20861,American Airlines,SFO,LAX
AA755,1697667600,1697667738,138,14297,American Airlines,LAX,SFO
AA755,1697691863,1697693037,1174,14458,American Airlines,SFO,LAX
AA755,1697710774,1697721305,10531,8496,American Airlines,LAX,ORD
AA755,1697734663,1697736108,1445,14470,American Airlines,ORD,MKE
AA755,1697758979,1697769277,10298,8790,American Airlines,MKE,ORD
AA755,1697784006,1697784880,874,3913,American Airlines,ORD,MKE
AA755,1697791050,1697792199,1149,17876,American Airlines,MKE,LAX
AA755,1697816689,1697818373,1684,21286,American Airlines,LAX,SFO
AA755,1697845006,1697854128,9122,12057,American Airlines,SFO,ORD
AA755,1697875656,1697877023,1367,8823,American Airlines,ORD,MKE
AA755,1697889913,1697894242,4329,7708,American Airlines,MKE,ORD
AA755,1697905484,1697905856,372,12770,American Airlines,ORD,MKE
AA755,1697928921,1697929445,524,7074,American Airlines,MKE,LAX
AA755,1697938393,1697947883,9490,20629,American Airlines,LAX,ORD
AA755,1697971493,1697972732,1239,17939,American Airlines,ORD,MKE
AA755,1697991345,1697992714,1369,20297,American Airlines,MKE,SFO
AA755,1698021974,1698023709,1735,7661,American Airlines,SFO,LAX
AA755,1698034661,1698034684,23,18108,American Airlines,LAX,SFO
AA755,1698062056,1698072541,10485,5750,American Airlines,SFO,ORD
AA755,1698084134,1698084490,356,12090,American Airlines,ORD,MKE
AA755,1698104211,1698104720,509,13202,American Airlines,MKE,SFO
AA755,1698118464,1698120236,1772,15518,American Airlines,SFO,LAX
AA755,1698142091,1698146703,4612,8674,American Airlines,LAX,ORD
AA755,1698165201,1698165408,207,9451,American Airlines,ORD,MKE
AA755,1698175683,1698177269,1586,19552,American Airlines,MKE,SFO
AA755,1698197521,1698198102,581,3873,American Airlines,SFO,LAX
AA755,1698212449,1698217136,4687,14626,American Airlines,LAX,ORD
AA755,1698237923,1698238491,568,15759,American Airlines,ORD,MKE
AA755,1698255082,1698256012,930,9425,American Airlines,MKE,LAX
AA755,1698270420,1698270943,523,20604,American Airlines,LAX,SFO
AA755,1698301144,1698302081,937,9692,American Airlines,SFO,LAX
AA755,1698319319,1698324638,5319,20949,American Airlines,LAX,ORD
AA755,1698348431,1698349880,1449,5577,American Airlines,ORD,MKE
AA755,1698363247,1698364609,1362,11229,American Airlines,MKE,LAX
AA755,1698378385,1698379082,697,11846,American Airlines,LAX,SFO
AA755,1698393139,1698394076,937,16929,American Airlines,SFO,LAX
AA755,1698420432,1698428878,8446,15212,American Airlines,LAX,ORD
AA755,1698450068,1698450661,593,21598,American Airlines,ORD,MKE
AA755,1698481520,1698488373,6853,18914,American Airlines,MKE,ORD
UA481,1682959659,1682961502,1843,20136,United Airlines,ORD,MKE
UA481,1682984037,1682988121,4084,18343,United Airlines,MKE,ORD
UA481,1683007181,1683013445,6264,18507,United Airlines,ORD,MKE
UA481,1683037967,1683045067,7100,19677,United Airlines,MKE,ORD
UA481,1683071429,1683078516,7087,16871,United Airlines,ORD,MKE
UA481,1683100119,1683106040,5921,6370,United Airlines,MKE,LAX
UA481,1683116032,1683123021,6989,9661,United Airlines,LAX,SFO
UA481,1683142080,1683150738,8658,13272,United Airlines,SFO,LAX
UA481,1683164707,1683170709,6002,20776,United Airlines,LAX,ORD
UA481,1683197812,1683199793,1981,20098,United Airlines,ORD,MKE
UA481,1683230684,1683234156,3472,12890,United Airlines,MKE,SFO
UA481,1683253460,1683263000,9540,9093,United Airlines,SFO,LAX
UA481,1683273708,1683279179,5471,6258,United Airlines,LAX,ORD
UA481,1683292346,1683299556,7210,5706,United Airlines,ORD,MKE
UA481,1683306369,1683312986,6617,13085,United Airlines,MKE,LAX
UA481,1683332237,1683339875,7638,7730,United Airlines,LAX,ORD
UA481,1683356358,1683363297,6939,20837,United Airlines,ORD,MKE
UA481,1683386470,1683392891,6421,10331,United Airlines,MKE,LAX
UA481,1683412451,1683421559,9108,17404,United Airlines,LAX,SFO
UA481,1683440386,1683445077,4691,11983,United Airlines,SFO,ORD
UA481,1683462321,1683470558,8237,20611,United Airlines,ORD,MKE
UA481,1683495311,1683504610,9299,17371,United Airlines,MKE,LAX
UA481,1683528030,1683531660,3630,17727,United Airlines,LAX,ORD
UA481,1683551577,1683558956,7379,18863,United Airlines,ORD,MKE
UA481,1683578924,1683582661,3737,5876,United Airlines,MKE,SFO
UA481,1683595314,1683599707,4393,9077,United Airlines,SFO,ORD
UA481,1683616444,1683625013,8569,20989,United Airlines,ORD,MKE
UA481,1683655075,1683662748,7673,17122,United Airlines,MKE,SFO
UA481,1683688409,1683693597,5188,9329,United Airlines,SFO,ORD
UA481,1683709191,1683717081,7890,16480,United Airlines,ORD,MKE
UA481,1683737041,1683742895,5854,19266,United Airlines,MKE,SFO
UA481,1683765278,1683770200,4922,8471,United Airlines,SFO,ORD
UA481,1683782432,1683786708,4276,21477,United Airlines,ORD,MKE
UA481,1683818538,1683824115,5577,5569,United Airlines,MKE,SFO
UA481,1683838648,1683847454,8806,11388,United Airlines,SFO,LAX
UA481,1683866494,1683876435,9941,12265,United Airlines,LAX,ORD
UA481,1683897180,1683906276,9096,9826,United Airlines,ORD,MKE
UA481,1683918345,1683927280,8935,10508,United Airlines,MKE,ORD
UA481,1683942441,1683946644,4203,13167,United Airlines,ORD,MKE
UA481,1683960208,1683970996,10788,4647,United Airlines,MKE,ORD
UA481,1683980181,1683988229,8048,14145,United Airlines,ORD,MKE
UA481,1684008485,1684010495,2010,18499,United Airlines,MKE,SFO
UA481,1684034073,1684038252,4179,16679,United Airlines,SFO,LAX
UA481,1684057910,1684065638,7728,9541,United Airlines,LAX,ORD
UA481,1684080174,1684083364,3190,18776,United Airlines,ORD,MKE
UA481,1684103461,1684112908,9447,16168,United Airlines,MKE,SFO
UA481,1684135729,1684140690,4961,20289,United Airlines,SFO,ORD
UA481,1684167574,1684173973,6399,16264,United Airlines,ORD,MKE
UA481,1684199536,1684206191,6655,20213,United Airlines,MKE,LAX
UA481,1684231037,1684233152,2115,7834,United Airlines,LAX,ORD
UA481,1684247881,1684251371,3490,21014,United Airlines,ORD,MKE
UA481,1684282837,1684293306,10469,4009,United Airlines,MKE,SFO
UA481,1684303918,1684309772,5854,11216,United Airlines,SFO,LAX
UA481,1684321290,1684329795,8505,20130,United Airlines,LAX,ORD
UA481,1684357855,1684367955,10100,8415,United Airlines,ORD,MKE
UA481,1684378548,1684386153,7605,21293,United Airlines,MKE,ORD
UA481,1684413664,1684419596,5932,5437,United Airlines,ORD,MKE
UA481,1684431078,1684434732,3654,16335,United Airlines,MKE,LAX
UA481,1684461500,1684463763,2263,11249,United Airlines,LAX,ORD
UA481,1684480088,1684490715,10627,11740,United Airlines,ORD,MKE
UA481,1684503942,1684508533,4591,16877,United Airlines,MKE,SFO
UA481,1684533871,1684542517,8646,15943,United Airlines,SFO,ORD
UA481,1684564840,1684566749,1909,11788,United Airlines,ORD,MKE
UA481,1684587558,1684590645,3087,4124,United Airlines,MKE,SFO
UA481,1684603288,1684611524,8236,7858,United Airlines,SFO,LAX
UA481,1684626295,1684636225,9930,13186,United Airlines,LAX,ORD
UA481,1684653929,1684660579,6650,10661,United Airlines,ORD,MKE
UA481,1684674160,1684684169,10009,20911,United Airlines,MKE,LAX
UA481,1684714836,1684720290,5454,10489,United Airlines,LAX,ORD
UA481,1684732703,1684734836,2133,14136,United Airlines,ORD,MKE
UA481,1684751332,1684760695,9363,13691,United Airlines,MKE,LAX
UA481,1684782296,1684789006,6710,10679,United Airlines,LAX,SFO
UA481,1684807328,1684812152,4824,11902,United Airlines,SFO,ORD
UA481,1684825366,1684830813,5447,8958,United Airlines,ORD,MKE
UA481,1684841363,1684848807,7444,17665,United Airlines,MKE,SFO
UA481,1684875423,1684883848,8425,13763,United Airlines,SFO,LAX
UA481,1684905317,1684914192,8875,7159,United Airlines,LAX,SFO
UA481,1684924303,1684932058,7755,17634,United Airlines,SFO,LAX
UA481,1684953674,1684955697,2023,20380,United Airlines,LAX,ORD
UA481,1684981578,1684986995,5417,12048,United Airlines,ORD,MKE
UA481,1685007439,1685010177,2738,16565,United Airlines,MKE,LAX
UA481,1685029631,1685031637,2006,12874,United Airlines,LAX,SFO
UA481,1685046402,1685051977,5575,11304,United Airlines,SFO,ORD
UA481,1685070069,1685079600,9531,10654,United Airlines,ORD,MKE
UA481,1685100882,1685104123,3241,17113,United Airlines,MKE,LAX
UA481,1685130174,1685136069,5895,8778,United Airlines,LAX,ORD
UA481,1685152107,1685159646,7539,10803,United Airlines,ORD,MKE
UA481,1685179224,1685184623,5399,16579,United Airlines,MKE,SFO
UA481,1685204933,1685213128,8195,8180,United Airlines,SFO,ORD
UA481,1685229615,1685232765,3150,7755,United Airlines,ORD,MKE
UA481,1685246776,1685253332,6556,4210,United Airlines,MKE,LAX
UA481,1685263526,1685272510,8984,5239,United Airlines,LAX,SFO
UA481,1685284280,1685294656,10376,11562,United Airlines,SFO,LAX
UA481,1685314474,1685324243,9769,18791,United Airlines,LAX,SFO
UA481,1685348600,1685351585,2985,5111,United Airlines,SFO,ORD
UA481,1685359833,1685362679,2846,5236,United Airlines,ORD,MKE
UA481,1685375085,1685385090,10005,16392,United Airlines,MKE,ORD
UA481,1685409819,1685418451,8632,16889,United Airlines,ORD,MKE
UA481,1685443777,1685448924,5147,17333,United Airlines,MKE,ORD
UA481,1685474365,1685481304,6939,15992,United Airlines,ORD,MKE
UA481,1685503497,1685510620,7123,15720,United Airlines,MKE,SFO
UA481,1685528219,1685533019,4800,8324,United Airlines,SFO,ORD
UA481,1685550480,1685555587,5107,10551,United Airlines,ORD,MKE
UA481,1685571327,1685577183,5856,7829,United Airlines,MKE,ORD
UA481,1685589553,1685595869,6316,4068,United Airlines,ORD,MKE
UA481,1685608283,1685613201,4918,16398,United Airlines,MKE,ORD
UA481,1685630348,1685633268,2920,11190,United Airlines,ORD,MKE
UA481,1685645770,1685655685,9915,21393,United Airlines,MKE,LAX
UA481,1685677784,1685685718,7934,13208,United Airlines,LAX,SFO
UA481,1685703248,1685708230,4982,20930,United Airlines,SFO,LAX
UA481,1685731487,1685738840,7353,20767,United Airlines,LAX,SFO
UA481,1685765327,1685769976,4649,5888,United Airlines,SFO,LAX
UA481,1685784533,1685792556,8023,15003,United Airlines,LAX,ORD
UA481,1685808158,1685815973,7815,16465,United Airlines,ORD,MKE
UA481,1685832506,1685835136,2630,8436,United Airlines,MKE,LAX
UA481,1685849594,1685858991,9397,7835,United Airlines,LAX,ORD
UA481,1685869419,1685872656,3237,4326,United Airlines,ORD,MKE
UA481,1685877467,1685882132,4665,12750,United Airlines,MKE,LAX
UA481,1685901216,1685907829,6613,13382,United Airlines,LAX,ORD
UA481,1685927900,1685938246,10346,4155,United Airlines,ORD,MKE
UA481,1685944741,1685947067,2326,13749,United Airlines,MKE,LAX
UA481,1685970263,1685973511,3248,4128,United Airlines,LAX,ORD
UA481,1685978365,1685984896,6531,8011,United Airlines,ORD,MKE
UA481,1685994698,1686002868,8170,4330,United Airlines,MKE,SFO
UA481,1686012667,1686017190,4523,6508,United Airlines,SFO,ORD
UA481,1686033412,1686038100,4688,6181,United Airlines,ORD,MKE
UA481,1686044427,1686054385,9958,21059,United Airlines,MKE,ORD
UA481,1686081863,1686084135,2272,19417,United Airlines,ORD,MKE
UA481,1686107870,1686112507,4637,8479,United Airlines,MKE,ORD
UA481,1686122045,1686124890,2845,11685,United Airlines,ORD,MKE
UA481,1686147133,1686156357,9224,6082,United Airlines,MKE,SFO
UA481,1686166690,1686169798,3108,10813,United Airlines,SFO,ORD
UA481,1686187757,1686198250,10493,8333,United Airlines,ORD,MKE
UA481,1686207943,1686218411,10468,4625,United Airlines,MKE,LAX
UA481,1686226683,1686229315,2632,5627,United Airlines,LAX,SFO
UA481,1686240559,1686248121,7562,17682,United Airlines,SFO,LAX
UA481,1686269402,1686278577,9175,8220,United Airlines,LAX,ORD
UA481,1686296197,1686299971,3774,12081,United Airlines,ORD,MKE
UA481,1686322544,1686327779,5235,10825,United Airlines,MKE,SFO
UA481,1686341515,1686346215,4700,11396,United Airlines,SFO,ORD
UA481,1686367282,1686373134,5852,17490,United Airlines,ORD,MKE
UA481,1686398038,1686406245,8207,10297,United Airlines,MKE,LAX
UA481,1686418505,1686428267,9762,12417,United Airlines,LAX,SFO
UA481,1686442335,1686446193,3858,13815,United Airlines,SFO,LAX
UA481,1686461439,1686471716,10277,20960,United Airlines,LAX,ORD
UA481,1686495221,1686505547,10326,18789,United Airlines,ORD,MKE
UA481,1686534592,1686540877,6285,6998,United Airlines,MKE,ORD
UA481,1686553479,1686559047,5568,14336,United Airlines,ORD,MKE
UA481,1686576011,1686580715,4704,13282,United Airlines,MKE,ORD
UA481,1686596317,1686601804,5487,14568,United Airlines,ORD,MKE
UA481,1686620935,1686623920,2985,14223,United Airlines,MKE,ORD
UA481,1686647425,1686651414,3989,9635,United Airlines,ORD,MKE
UA481,1686668725,1686679442,10717,20024,United Airlines,MKE,ORD
UA481,1686707360,1686709179,1819,19308,United Airlines,ORD,MKE
UA481,1686734786,1686738993,4207,16181,United Airlines,MKE,ORD
UA481,1686763833,1686765799,1966,8925,United Airlines,ORD,MKE
UA481,1686784196,1686793586,9390,14614,United Airlines,MKE,SFO
UA481,1686818857,1686827053,8196,12890,United Airlines,SFO,LAX
UA481,1686846307,1686851882,5575,20850,United Airlines,LAX,SFO
UA481,1686877346,1686887308,9962,5804,United Airlines,SFO,LAX
UA481,1686893371,1686896903,3532,13089,United Airlines,LAX,ORD
UA481,1686911817,1686920278,8461,20988,United Airlines,ORD,MKE
UA481,1686950894,1686954000,3106,16966,United Airlines,MKE,LAX
UA481,1686975279,1686983733,8454,4448,United Airlines,LAX,ORD
UA481,1686997869,1687003973,6104,20997,United Airlines,ORD,MKE
UA481,1687030526,1687034279,3753,16504,United Airlines,MKE,SFO
UA481,1687057268,1687063376,6108,21486,United Airlines,SFO,LAX
UA481,1687093318,1687097089,3771,11857,United Airlines,LAX,SFO
UA481,1687111594,1687121133,9539,12646,United Airlines,SFO,ORD
UA481,1687139472,1687149355,9883,20893,United Airlines,ORD,MKE
UA481,1687171607,1687179343,7736,13691,United Airlines,MKE,LAX
UA481,1687201106,1687209293,8187,15449,United Airlines,LAX,ORD
UA481,1687228959,1687235268,6309,9008,United Airlines,ORD,MKE
UA481,1687250403,1687259693,9290,8391,United Airlines,MKE,ORD
UA481,1687270032,1687274222,4190,21269,United Airlines,ORD,MKE
UA481,1687299628,1687308032,8404,11341,United Airlines,MKE,ORD
UA481,1687320940,1687331557,10617,9048,United Airlines,ORD,MKE
UA481,1687341018,1687349636,8618,9740,United Airlines,MKE,SFO
UA481,1687360609,1687367498,6889,18928,United Airlines,SFO,LAX
UA481,1687392536,1687399112,6576,4618,United Airlines,LAX,ORD
UA481,1687413392,1687422383,8991,17665,United Airlines,ORD,MKE
UA481,1687449078,1687458160,9082,18048,United Airlines,MKE,LAX
UA481,1687477022,1687484782,7760,4634,United Airlines,LAX,SFO
UA481,1687493941,1687500006,6065,12450,United Airlines,SFO,ORD
UA481,1687517298,1687527579,10281,17486,United Airlines,ORD,MKE
UA481,1687547794,1687552790,4996,14081,United Airlines,MKE,LAX
UA481,1687577051,1687580741,3690,8583,United Airlines,LAX,ORD
UA481,1687592949,1687595671,2722,18113,United Airlines,ORD,MKE
UA481,1687618279,1687626262,7983,9231,United Airlines,MKE,SFO
UA481,1687637458,1687642204,4746,6456,United Airlines,SFO,ORD
UA481,1687654862,1687664705,9843,6752,United Airlines,ORD,MKE
UA481,1687673817,1687676390,2573,9704,United Airlines,MKE,ORD
UA481,1687689547,1687693763,4216,6332,United Airlines,ORD,MKE
UA481,1687706857,1687716031,9174,7204,United Airlines,MKE,SFO
UA481,1687733465,1687737381,3916,9593,United Airlines,SFO,ORD
UA481,1687756314,1687764449,8135,21164,United Airlines,ORD,MKE
UA481,1687789355,1687794174,4819,7083,United Airlines,MKE,LAX
UA481,1687810164,1687817796,7632,14493,United Airlines,LAX,SFO
UA481,1687840271,1687847042,6771,13498,United Airlines,SFO,LAX
UA481,1687867620,1687876966,9346,8592,United Airlines,LAX,SFO
UA481,1687889995,1687893254,3259,9697,United Airlines,SFO,ORD
UA481,1687910004,1687916702,6698,16994,United Airlines,ORD,MKE
UA481,1687935177,1687937386,2209,13266,United Airlines,MKE,LAX
UA481,1687960330,1687966962,6632,5260,United Airlines,LAX,ORD
UA481,1687979833,1687982451,2618,12048,United Airlines,ORD,MKE
UA481,1688003767,1688013728,9961,17239,United Airlines,MKE,ORD
UA481,1688034688,1688042777,8089,9862,United Airlines,ORD,MKE
UA481,1688061754,1688068938,7184,17059,United Airlines,MKE,LAX
UA481,1688090909,1688097962,7053,5588,United Airlines,LAX,ORD
UA481,1688109629,1688117092,7463,9130,United Airlines,ORD,MKE
UA481,1688133740,1688136505,2765,19522,United Airlines,MKE,LAX
UA481,1688157402,1688163906,6504,8333,United Airlines,LAX,SFO
UA481,1688173108,1688176218,3110,5833,United Airlines,SFO,ORD
UA481,1688182936,1688187687,4751,15318,United Airlines,ORD,MKE
UA481,1688211968,1688222606,10638,5251,United Airlines,MKE,SFO
UA481,1688230434,1688233404,2970,20297,United Airlines,SFO,LAX
UA481,1688258446,1688266268,7822,6683,United Airlines,LAX,ORD
UA481,1688282233,1688286047,3814,6786,United Airlines,ORD,MKE
UA481,1688295921,1688302085,6164,8273,United Airlines,MKE,LAX
UA481,1688315642,1688323927,8285,12587,United Airlines,LAX,ORD
UA481,1688339509,1688346118,6609,21052,United Airlines,ORD,MKE
UA481,1688373287,1688379616,6329,17253,United Airlines,MKE,LAX
UA481,1688401064,1688410518,9454,6425,United Airlines,LAX,SFO
UA481,1688423445,1688429000,5555,5799,United Airlines,SFO,LAX
UA481,1688443059,1688451447,8388,17145,United Airlines,LAX,ORD
UA481,1688478847,1688486158,7311,9834,United Airlines,ORD,MKE
UA481,1688503060,1688510113,7053,10765,United Airlines,MKE,ORD
UA481,1688526862,1688532972,6110,15214,United Airlines,ORD,MKE
UA481,1688552013,1688555242,3229,14389,United Airlines,MKE,SFO
UA481,1688579464,1688587088,7624,6585,United Airlines,SFO,LAX
UA481,1688596692,1688604199,7507,13954,United Airlines,LAX,ORD
UA481,1688626625,1688632452,5827,9262,United Airlines,ORD,MKE
UA481,1688650196,1688655756,5560,19286,United Airlines,MKE,ORD
UA481,1688684024,1688690687,6663,20618,United Airlines,ORD,MKE
UA481,1688711725,1688715440,3715,3693,United Airlines,MKE,LAX
UA481,1688725837,1688730970,5133,19089,United Airlines,LAX,SFO
UA481,1688758826,1688763738,4912,9179,United Airlines,SFO,ORD
UA481,1688782134,1688788604,6470,15600,United Airlines,ORD,MKE
UA481,1688806974,1688814241,7267,20164,United Airlines,MKE,ORD
UA481,1688840866,1688849582,8716,9700,United Airlines,ORD,MKE
UA481,1688867567,1688869625,2058,10535,United Airlines,MKE,SFO
UA481,1688887753,1688897018,9265,20462,United Airlines,SFO,ORD
UA481,1688922913,1688925611,2698,10801,United Airlines,ORD,MKE
UA481,1688946828,1688956252,9424,6832,United Airlines,MKE,SFO
UA481,1688967228,1688969365,2137,20850,United Airlines,SFO,LAX
UA481,1688994728,1689004698,9970,8081,United Airlines,LAX,ORD
UA481,1689017355,1689025196,7841,8596,United Airlines,ORD,MKE
UA481,1689035410,1689044529,9119,9065,United Airlines,MKE,LAX
UA481,1689064276,1689067742,3466,10951,United Airlines,LAX,SFO
UA481,1689085119,1689094533,9414,12053,United Airlines,SFO,LAX
UA481,1689114482,1689122387,7905,14055,United Airlines,LAX,ORD
UA481,1689137680,1689142860,5180,19535,United Airlines,ORD,MKE
UA481,1689163162,1689167622,4460,13253,United Airlines,MKE,LAX
UA481,1689182863,1689185644,2781,10751,United Airlines,LAX,SFO
UA481,1689198735,1689200616,1881,20183,United Airlines,SFO,LAX
UA481,1689222005,1689229323,7318,16324,United Airlines,LAX,SFO
UA481,1689249601,1689254733,5132,12569,United Airlines,SFO,ORD
UA481,1689274962,1689278221,3259,7891,United Airlines,ORD,MKE
UA481,1689292160,1689296290,4130,12180,United Airlines,MKE,LAX
UA481,1689318945,1689327436,8491,14946,United Airlines,LAX,ORD
UA481,1689342531,1689350300,7769,7682,United Airlines,ORD,MKE
UA481,1689368083,1689378258,10175,9260,United Airlines,MKE,ORD
UA481,1689395367,1689405411,10044,9274,United Airlines,ORD,MKE
UA481,1689418808,1689422525,3717,6447,United Airlines,MKE,LAX
UA481,1689437704,1689445173,7469,17880,United Airlines,LAX,SFO
UA481,1689468144,1689473509,5365,13655,United Airlines,SFO,LAX
UA481,1689491168,1689499949,8781,18356,United Airlines,LAX,SFO
UA481,1689526963,1689534151,7188,12200,United Airlines,SFO,LAX
UA481,1689554762,1689562402,7640,20807,United Airlines,LAX,ORD
UA481,1689585571,1689595428,9857,13938,United Airlines,ORD,MKE
UA481,1689614909,1689624496,9587,12829,United Airlines,MKE,LAX
UA481,1689637597,1689647949,10352,8091,United Airlines,LAX,ORD
UA481,1689665969,1689674468,8499,6163,United Airlines,ORD,MKE
UA481,1689684082,1689687671,3589,14893,United Airlines,MKE,LAX
UA481,1689704105,1689706080,1975,15695,United Airlines,LAX,SFO
UA481,1689724639,1689731655,7016,9017,United Airlines,SFO,ORD
UA481,1689749355,1689752847,3492,6496,United Airlines,ORD,MKE
UA481,1689759645,1689761994,2349,5048,United Airlines,MKE,SFO
UA481,1689773839,1689779589,5750,9438,United Airlines,SFO,LAX
UA481,1689796704,1689800125,3421,12588,United Airlines,LAX,ORD
UA481,1689820247,1689830268,10021,6642,United Airlines,ORD,MKE
UA481,1689836982,1689846193,9211,21471,United Airlines,MKE,LAX
UA481,1689872499,1689876079,3580,21253,United Airlines,LAX,ORD
UA481,1689898153,1689908833,10680,19638,United Airlines,ORD,MKE
UA481,1689933637,1689935954,2317,21570,United Airlines,MKE,ORD
UA481,1689960525,1689964603,4078,6615,United Airlines,ORD,MKE
UA481,1689978680,1689989059,10379,14328,United Airlines,MKE,LAX
UA481,1690008609,1690013480,4871,16198,United Airlines,LAX,ORD
UA481,1690040051,1690049334,9283,19149,United Airlines,ORD,MKE
UA481,1690071877,1690075670,3793,14158,United Airlines,MKE,LAX
UA481,1690097069,1690105418,8349,14360,United Airlines,LAX,SFO
UA481,1690129922,1690139432,9510,8239,United Airlines,SFO,ORD
UA481,1690148207,1690151850,3643,8493,United Airlines,ORD,MKE
UA481,1690169526,1690177336,7810,15491,United Airlines,MKE,ORD
UA481,1690196064,1690198134,2070,11710,United Airlines,ORD,MKE
UA481,1690215562,1690223522,7960,14030,United Airlines,MKE,SFO
UA481,1690244260,1690248127,3867,6355,United Airlines,SFO,LAX
UA481,1690256650,1690261564,4914,12679,United Airlines,LAX,ORD
UA481,1690284341,1690286311,1970,7906,United Airlines,ORD,MKE
UA481,1690302347,1690308386,6039,6547,United Airlines,MKE,SFO
UA481,1690315873,1690320344,4471,3980,United Airlines,SFO,ORD
UA481,1690333420,1690343394,9974,13454,United Airlines,ORD,MKE
UA481,1690364155,1690373281,9126,20234,United Airlines,MKE,ORD
UA481,1690402528,1690406400,3872,17882,United Airlines,ORD,MKE
UA481,1690425326,1690427343,2017,13051,United Airlines,MKE,LAX
UA481,1690446623,1690455148,8525,10786,United Airlines,LAX,ORD
UA481,1690474150,1690480378,6228,13369,United Airlines,ORD,MKE
UA481,1690493750,1690504341,10591,5843,United Airlines,MKE,LAX
UA481,1690512754,1690519040,6286,14494,United Airlines,LAX,ORD
UA481,1690538033,1690541561,3528,8406,United Airlines,ORD,MKE
UA481,1690553044,1690559791,6747,12028,United Airlines,MKE,LAX
UA481,1690574093,1690584354,10261,16131,United Airlines,LAX,ORD
UA481,1690605864,1690616608,10744,7823,United Airlines,ORD,MKE
UA481,1690634735,1690637292,2557,18240,United Airlines,MKE,LAX
UA481,1690663029,1690666571,3542,20651,United Airlines,LAX,ORD
UA481,1690689524,1690693308,3784,18596,United Airlines,ORD,MKE
UA481,1690716191,1690724684,8493,10467,United Airlines,MKE,LAX
UA481,1690739293,1690741569,2276,13987,United Airlines,LAX,SFO
UA481,1690758591,1690763687,5096,20665,United Airlines,SFO,ORD
UA481,1690791245,1690798213,6968,21516,United Airlines,ORD,MKE
UA481,1690825105,1690831942,6837,11384,United Airlines,MKE,LAX
UA481,1690845511,1690847553,2042,4971,United Airlines,LAX,ORD
UA481,1690863130,1690870899,7769,16058,United Airlines,ORD,MKE
UA481,1690892078,1690897430,5352,12102,United Airlines,MKE,SFO
UA481,1690915941,1690923380,7439,15079,United Airlines,SFO,LAX
UA481,1690940987,1690943528,2541,20322,United Airlines,LAX,SFO
UA481,1690968555,1690976755,8200,14183,United Airlines,SFO,ORD
UA481,1690994374,1691003645,9271,16378,United Airlines,ORD,MKE
UA481,1691021440,1691031407,9967,7175,United Airlines,MKE,ORD
UA481,1691047572,1691056938,9366,21329,United Airlines,ORD,MKE
UA481,1691086921,1691089144,2223,8649,United Airlines,MKE,SFO
UA481,1691098672,1691102355,3683,7770,United Airlines,SFO,LAX
UA481,1691115254,1691122817,7563,13367,United Airlines,LAX,ORD
UA481,1691146187,1691149313,3126,19056,United Airlines,ORD,MKE
UA481,1691179139,1691186394,7255,15428,United Airlines,MKE,SFO
UA481,1691210803,1691220821,10018,10269,United Airlines,SFO,LAX
UA481,1691239939,1691245788,5849,9084,United Airlines,LAX,SFO
UA481,1691258354,1691268193,9839,13213,United Airlines,SFO,LAX
UA481,1691291940,1691300547,8607,8976,United Airlines,LAX,SFO
UA481,1691312812,1691320510,7698,10898,United Airlines,SFO,ORD
UA481,1691338045,1691347797,9752,17671,United Airlines,ORD,MKE
UA481,1691374621,1691378725,4104,4193,United Airlines,MKE,SFO
UA481,1691392081,1691397965,5884,14683,United Airlines,SFO,ORD
UA481,1691416852,1691421683,4831,19137,United Airlines,ORD,MKE
UA481,1691444138,1691454191,10053,17841,United Airlines,MKE,LAX
UA481,1691473602,1691483972,10370,15301,United Airlines,LAX,SFO
UA481,1691509513,1691519184,9671,7430,United Airlines,SFO,LAX
UA481,1691537053,1691542817,5764,18905,United Airlines,LAX,ORD
UA481,1691569192,1691572376,3184,16692,United Airlines,ORD,MKE
UA481,1691593323,1691600093,6770,17132,United Airlines,MKE,ORD
UA481,1691617925,1691623054,5129,12738,United Airlines,ORD,MKE
UA481,1691636486,1691642191,5705,8938,United Airlines,MKE,SFO
UA481,1691654847,1691657028,2181,6834,United Airlines,SFO,LAX
UA481,1691667859,1691674713,6854,10384,United Airlines,LAX,ORD
UA481,1691690713,1691695512,4799,8614,United Airlines,ORD,MKE
UA481,1691709836,1691712904,3068,21243,United Airlines,MKE,ORD
UA481,1691738748,1691744387,5639,17221,United Airlines,ORD,MKE
UA481,1691767371,1691776280,8909,12418,United Airlines,MKE,LAX
UA481,1691796606,1691800149,3543,20444,United Airlines,LAX,SFO
UA481,1691824387,1691832589,8202,4891,United Airlines,SFO,LAX
UA481,1691837987,1691844143,6156,18288,United Airlines,LAX,SFO
UA481,1691870350,1691873686,3336,13146,United Airlines,SFO,ORD
UA481,1691895845,1691902947,7102,3671,United Airlines,ORD,MKE
UA481,1691914242,1691922968,8726,16016,United Airlines,MKE,LAX
UA481,1691943141,1691949777,6636,16138,United Airlines,LAX,ORD
UA481,1691968711,1691975076,6365,14900,United Airlines,ORD,MKE
UA481,1691993111,1691996866,3755,9924,United Airlines,MKE,ORD
UA481,1692013755,1692019090,5335,19847,United Airlines,ORD,MKE
UA481,1692039168,1692048378,9210,5758,United Airlines,MKE,LAX
UA481,1692063729,1692066248,2519,18714,United Airlines,LAX,ORD
UA481,1692093412,1692103704,10292,12495,United Airlines,ORD,MKE
UA481,1692119090,1692124673,5583,20220,United Airlines,MKE,LAX
UA481,1692153871,1692161216,7345,20946,United Airlines,LAX,ORD
UA481,1692185262,1692194280,9018,15484,United Airlines,ORD,MKE
UA481,1692215869,1692221008,5139,16466,United Airlines,MKE,LAX
UA481,1692244777,1692251795,7018,21263,United Airlines,LAX,SFO
UA481,1692283373,1692293244,9871,12880,United Airlines,SFO,LAX
UA481,1692310276,1692317160,6884,16069,United Airlines,LAX,SFO
UA481,1692339105,1692342551,3446,18109,United Airlines,SFO,LAX
UA481,1692362064,1692369634,7570,16492,United Airlines,LAX,SFO
UA481,1692393823,1692396408,2585,19524,United Airlines,SFO,ORD
UA481,1692424191,1692431049,6858,21522,United Airlines,ORD,MKE
UA481,1692452925,1692455868,2943,7463,United Airlines,MKE,LAX
UA481,1692466984,1692469641,2657,12012,United Airlines,LAX,ORD
UA481,1692492160,1692496303,4143,10767,United Airlines,ORD,MKE
UA481,1692509228,1692511812,2584,15184,United Airlines,MKE,ORD
UA481,1692534785,1692536806,2021,15530,United Airlines,ORD,MKE
UA481,1692563063,1692571885,8822,4408,United Airlines,MKE,LAX
UA481,1692580170,1692589620,9450,6104,United Airlines,LAX,SFO
UA481,1692597430,1692601006,3576,20416,United Airlines,SFO,ORD
UA481,1692624663,1692635265,10602,15590,United Airlines,ORD,MKE
UA481,1692659493,1692668996,9503,9281,United Airlines,MKE,SFO
UA481,1692683291,1692694025,10734,17885,United Airlines,SFO,LAX
UA481,1692718767,1692725720,6953,6235,United Airlines,LAX,SFO
UA481,1692733536,1692740568,7032,5113,United Airlines,SFO,LAX
UA481,1692752464,1692757938,5474,11072,United Airlines,LAX,ORD
UA481,1692770968,1692774839,3871,15048,United Airlines,ORD,MKE
UA481,1692794745,1692804128,9383,17070,United Airlines,MKE,ORD
UA481,1692829408,1692834630,5222,18990,United Airlines,ORD,MKE
UA481,1692856274,1692862999,6725,16555,United Airlines,MKE,ORD
UA481,1692880504,1692882442,1938,18336,United Airlines,ORD,MKE
UA481,1692909769,1692920016,10247,9875,United Airlines,MKE,ORD
UA481,1692934753,1692941051,6298,18125,United Airlines,ORD,MKE
UA481,1692968894,1692973334,4440,4898,United Airlines,MKE,LAX
UA481,1692987075,1692994813,7738,15913,United Airlines,LAX,ORD
UA481,1693020411,1693025321,4910,9551,United Airlines,ORD,MKE
UA481,1693037871,1693048101,10230,3663,United Airlines,MKE,SFO
UA481,1693055929,1693060287,4358,21396,United Airlines,SFO,LAX
UA481,1693085165,1693094834,9669,9624,United Airlines,LAX,SFO
UA481,1693108012,1693113123,5111,19200,United Airlines,SFO,LAX
UA481,1693136174,1693145187,9013,19319,United Airlines,LAX,SFO
UA481,1693165237,1693170988,5751,8914,United Airlines,SFO,ORD
UA481,1693185927,1693195377,9450,10528,United Airlines,ORD,MKE
UA481,1693215446,1693220806,5360,7301,United Airlines,MKE,LAX
UA481,1693229651,1693238123,8472,8005,United Airlines,LAX,SFO
UA481,1693250226,1693254341,4115,14789,United Airlines,SFO,ORD
UA481,1693278768,1693286002,7234,18955,United Airlines,ORD,MKE
UA481,1693306948,1693314995,8047,5822,United Airlines,MKE,SFO
UA481,1693330337,1693339850,9513,9980,United Airlines,SFO,ORD
UA481,1693350520,1693358915,8395,14846,United Airlines,ORD,MKE
UA481,1693374970,1693376820,1850,11728,United Airlines,MKE,LAX
UA481,1693396200,1693399402,3202,13562,United Airlines,LAX,ORD
UA481,1693413921,1693416735,2814,4194,United Airlines,ORD,MKE
UA481,1693430288,1693434982,4694,5725,United Airlines,MKE,LAX
UA481,1693441020,1693443563,2543,17968,United Airlines,LAX,SFO
UA481,1693462517,1693466788,4271,12224,United Airlines,SFO,LAX
UA481,1693479704,1693488567,8863,17746,United Airlines,LAX,ORD
UA481,1693510333,1693516780,6447,18154,United Airlines,ORD,MKE
UA481,1693542877,1693546736,3859,10757,United Airlines,MKE,SFO
UA481,1693564595,1693573338,8743,19125,United Airlines,SFO,ORD
UA481,1693600018,1693608591,8573,11745,United Airlines,ORD,MKE
UA481,1693628401,1693635772,7371,5044,United Airlines,MKE,ORD
UA481,1693647134,1693656224,9090,14586,United Airlines,ORD,MKE
UA481,1693679896,1693689844,9948,14606,United Airlines,MKE,LAX
UA481,1693712870,1693716440,3570,16539,United Airlines,LAX,ORD
UA481,1693740246,1693747486,7240,15583,United Airlines,ORD,MKE
UA481,1693769426,1693773272,3846,9065,United Airlines,MKE,LAX
UA481,1693792102,1693796955,4853,9836,United Airlines,LAX,ORD
UA481,1693806951,1693812092,5141,4174,United Airlines,ORD,MKE
UA481,1693822404,1693825336,2932,7204,United Airlines,MKE,ORD
UA481,1693840724,1693846569,5845,3654,United Airlines,ORD,MKE
UA481,1693850316,1693857042,6726,9582,United Airlines,MKE,SFO
UA481,1693868664,1693871121,2457,5175,United Airlines,SFO,ORD
UA481,1693879898,1693882399,2501,14557,United Airlines,ORD,MKE
UA481,1693902812,1693909285,6473,7079,United Airlines,MKE,ORD
UA481,1693926722,1693935734,9012,9701,United Airlines,ORD,MKE
UA481,1693949716,1693954602,4886,19158,United Airlines,MKE,LAX
UA481,1693978413,1693982511,4098,11761,United Airlines,LAX,ORD
UA481,1693997353,1694007624,10271,21212,United Airlines,ORD,MKE
UA481,1694033704,1694035532,1828,13990,United Airlines,MKE,SFO
UA481,1694054898,1694063304,8406,18654,United Airlines,SFO,LAX
UA481,1694091777,1694093774,1997,14550,United Airlines,LAX,ORD
UA481,1694117632,1694121835,4203,16968,United Airlines,ORD,MKE
UA481,1694147639,1694152261,4622,6753,United Airlines,MKE,ORD
UA481,1694159304,1694168121,8817,14607,United Airlines,ORD,MKE
UA481,1694184378,1694190545,6167,7808,United Airlines,MKE,LAX
UA481,1694205967,1694212405,6438,3746,United Airlines,LAX,ORD
UA481,1694221501,1694224595,3094,13886,United Airlines,ORD,MKE
UA481,1694246765,1694250463,3698,7237,United Airlines,MKE,LAX
UA481,1694261815,1694265901,4086,9574,United Airlines,LAX,ORD
UA481,1694283948,1694290830,6882,5397,United Airlines,ORD,MKE
UA481,1694304958,1694308815,3857,21322,United Airlines,MKE,SFO
UA481,1694339716,1694346687,6971,7023,United Airlines,SFO,LAX
UA481,1694364070,1694369221,5151,13055,United Airlines,LAX,ORD
UA481,1694393018,1694401306,8288,13545,United Airlines,ORD,MKE
UA481,1694424273,1694430114,5841,17701,United Airlines,MKE,ORD
UA481,1694449092,1694454897,5805,15430,United Airlines,ORD,MKE
UA481,1694481034,1694489384,8350,20787,United Airlines,MKE,SFO
UA481,1694513426,1694515825,2399,5150,United Airlines,SFO,LAX
UA481,1694528969,1694535035,6066,9485,United Airlines,LAX,ORD
UA481,1694549000,1694556582,7582,13613,United Airlines,ORD,MKE
UA481,1694570725,1694580714,9989,12261,United Airlines,MKE,LAX
UA481,1694600114,1694608522,8408,10179,United Airlines,LAX,SFO
UA481,1694628432,1694638140,9708,11543,United Airlines,SFO,ORD
UA481,1694652649,1694656843,4194,16149,United Airlines,ORD,MKE
UA481,1694675921,1694680297,4376,20700,United Airlines,MKE,SFO
UA481,1694705371,1694708646,3275,9905,United Airlines,SFO,ORD
UA481,1694722162,1694729857,7695,6221,United Airlines,ORD,MKE
UA481,1694742794,1694745975,3181,14069,United Airlines,MKE,LAX
UA481,1694765818,1694772432,6614,21379,United Airlines,LAX,SFO
UA481,1694804442,1694809295,4853,20481,United Airlines,SFO,ORD
UA481,1694832754,1694837148,4394,9601,United Airlines,ORD,MKE
UA481,1694851553,1694855799,4246,3664,United Airlines,MKE,ORD
UA481,1694868590,1694878281,9691,19743,United Airlines,ORD,MKE
UA481,1694899646,1694907398,7752,11116,United Airlines,MKE,SFO
UA481,1694922092,1694926978,4886,4597,United Airlines,SFO,ORD
UA481,1694938421,1694948526,10105,21559,United Airlines,ORD,MKE
UA481,1694972427,1694983088,10661,10748,United Airlines,MKE,LAX
UA481,1694999069,1695002752,3683,20114,United Airlines,LAX,ORD
UA481,1695026302,1695036277,9975,10065,United Airlines,ORD,MKE
UA481,1695055397,1695059515,4118,6757,United Airlines,MKE,ORD
UA481,1695076528,1695079771,3243,15846,United Airlines,ORD,MKE
UA481,1695097469,1695101106,3637,11627,United Airlines,MKE,SFO
UA481,1695121778,1695128110,6332,19284,United Airlines,SFO,ORD
UA481,1695151261,1695159383,8122,4592,United Airlines,ORD,MKE
UA481,1695163981,1695169628,5647,19285,United Airlines,MKE,LAX
UA481,1695197614,1695202934,5320,5604,United Airlines,LAX,SFO
UA481,1695212092,1695218501,6409,14739,United Airlines,SFO,ORD
UA481,1695243585,1695253669,10084,16244,United Airlines,ORD,MKE
UA481,1695276683,1695278564,1881,4190,United Airlines,MKE,ORD
UA481,1695285957,1695292031,6074,10079,United Airlines,ORD,MKE
UA481,1695305772,1695308024,2252,20762,United Airlines,MKE,ORD
UA481,1695336200,1695340698,4498,20971,United Airlines,ORD,MKE
UA481,1695372214,1695375327,3113,15444,United Airlines,MKE,SFO
UA481,1695400837,1695407229,6392,13992,United Airlines,SFO,ORD
UA481,1695431632,1695441416,9784,15919,United Airlines,ORD,MKE
UA481,1695458087,1695463967,5880,10962,United Airlines,MKE,SFO
UA481,1695481095,1695484606,3511,13735,United Airlines,SFO,LAX
UA481,1695501298,1695504278,2980,6082,United Airlines,LAX,ORD
UA481,1695510651,1695520580,9929,11051,United Airlines,ORD,MKE
UA481,1695541143,1695546397,5254,9409,United Airlines,MKE,SFO
UA481,1695566351,1695568349,1998,8354,United Airlines,SFO,LAX
UA481,1695578693,1695584847,6154,11563,United Airlines,LAX,SFO
UA481,1695600990,1695605891,4901,18011,United Airlines,SFO,ORD
UA481,1695624995,1695627459,2464,5720,United Airlines,ORD,MKE
UA481,1695642984,1695645222,2238,10929,United Airlines,MKE,SFO
UA481,1695666220,1695671197,4977,14271,United Airlines,SFO,LAX
UA481,1695688210,1695694952,6742,21256,United Airlines,LAX,SFO
UA481,1695718676,1695723816,5140,21198,United Airlines,SFO,ORD
UA481,1695750162,1695757763,7601,10154,United Airlines,ORD,MKE
UA481,1695771633,1695774241,2608,18080,United Airlines,MKE,SFO
UA481,1695799716,1695808508,8792,6591,United Airlines,SFO,ORD
UA481,1695824476,1695834180,9704,10374,United Airlines,ORD,MKE
UA481,1695845962,1695856047,10085,10870,United Airlines,MKE,ORD
UA481,1695876073,1695880702,4629,5994,United Airlines,ORD,MKE
UA481,1695895382,1695898518,3136,17396,United Airlines,MKE,SFO
UA481,1695918249,1695921123,2874,8266,United Airlines,SFO,ORD
UA481,1695937395,1695945663,8268,9904,United Airlines,ORD,MKE
UA481,1695961014,1695964506,3492,3698,United Airlines,MKE,SFO
UA481,1695973808,1695984061,10253,19389,United Airlines,SFO,LAX
UA481,1696005383,1696015126,9743,16672,United Airlines,LAX,SFO
UA481,1696038967,1696043424,4457,16070,United Airlines,SFO,LAX
UA481,1696069900,1696071891,1991,13819,United Airlines,LAX,ORD
UA481,1696093342,1696099923,6581,10634,United Airlines,ORD,MKE
UA481,1696112107,1696116065,3958,7949,United Airlines,MKE,LAX
UA481,1696128612,1696132280,3668,8288,United Airlines,LAX,ORD
UA481,1696141887,1696145086,3199,9799,United Airlines,ORD,MKE
UA481,1696163983,1696174741,10758,19600,United Airlines,MKE,SFO
UA481,1696199525,1696207028,7503,6867,United Airlines,SFO,ORD
UA481,1696216840,1696220296,3456,6616,United Airlines,ORD,MKE
UA481,1696228445,1696232131,3686,13558,United Airlines,MKE,LAX
UA481,1696253302,1696258987,5685,17285,United Airlines,LAX,ORD
UA481,1696283072,1696287854,4782,21216,United Airlines,ORD,MKE
UA481,1696318036,1696327044,9008,12785,United Airlines,MKE,SFO
UA481,1696345523,1696355260,9737,20480,United Airlines,SFO,LAX
UA481,1696378153,1696382202,4049,19702,United Airlines,LAX,ORD
UA481,1696405613,1696407454,1841,4211,United Airlines,ORD,MKE
UA481,1696419553,1696424137,4584,13434,United Airlines,MKE,SFO
UA481,1696443766,1696447480,3714,10521,United Airlines,SFO,LAX
UA481,1696461094,1696469610,8516,21037,United Airlines,LAX,SFO
UA481,1696492293,1696501941,9648,19211,United Airlines,SFO,LAX
UA481,1696524258,1696526142,1884,13755,United Airlines,LAX,SFO
UA481,1696548984,1696556123,7139,12581,United Airlines,SFO,LAX
UA481,1696576732,1696584075,7343,4463,United Airlines,LAX,SFO
UA481,1696598869,1696604668,5799,18388,United Airlines,SFO,LAX
UA481,1696626937,1696637463,10526,5126,United Airlines,LAX,SFO
UA481,1696652019,1696662381,10362,20884,United Airlines,SFO,LAX
UA481,1696687536,1696691705,4169,8941,United Airlines,LAX,ORD
UA481,1696703238,1696706045,2807,21470,United Airlines,ORD,MKE
UA481,1696729425,1696736747,7322,17971,United Airlines,MKE,SFO
UA481,1696759479,1696767826,8347,13132,United Airlines,SFO,ORD
UA481,1696787534,1696791710,4176,7671,United Airlines,ORD,MKE
UA481,1696804912,1696811933,7021,8482,United Airlines,MKE,ORD
UA481,1696830836,1696839699,8863,7184,United Airlines,ORD,MKE
UA481,1696847039,1696855428,8389,13206,United Airlines,MKE,ORD
UA481,1696877224,1696883198,5974,11496,United Airlines,ORD,MKE
UA481,1696896749,1696904748,7999,7311,United Airlines,MKE,LAX
UA481,1696915744,1696922013,6269,19897,United Airlines,LAX,SFO
UA481,1696943618,1696945917,2299,19994,United Airlines,SFO,LAX
UA481,1696975090,1696980931,5841,17445,United Airlines,LAX,ORD
UA481,1697004221,1697011287,7066,13454,United Airlines,ORD,MKE
UA481,1697025407,1697031153,5746,4436,United Airlines,MKE,LAX
UA481,1697040900,1697049597,8697,5460,United Airlines,LAX,SFO
UA481,1697061063,1697070636,9573,7798,United Airlines,SFO,LAX
UA481,1697078730,1697085259,6529,17451,United Airlines,LAX,ORD
UA481,1697108504,1697115323,6819,6472,United Airlines,ORD,MKE
UA481,1697121845,1697129030,7185,4533,United Airlines,MKE,LAX
UA481,1697135824,1697142181,6357,6977,United Airlines,LAX,ORD
UA481,1697150162,1697157475,7313,9540,United Airlines,ORD,MKE
UA481,1697177223,1697182303,5080,7663,United Airlines,MKE,ORD
UA481,1697192823,1697202949,10126,4329,United Airlines,ORD,MKE
UA481,1697217541,1697219618,2077,10519,United Airlines,MKE,ORD
UA481,1697236260,1697246166,9906,8943,United Airlines,ORD,MKE
UA481,1697261278,1697271324,10046,11363,United Airlines,MKE,ORD
UA481,1697291785,1697300723,8938,11862,United Airlines,ORD,MKE
UA481,1697316936,1697320505,3569,14077,United Airlines,MKE,LAX
UA481,1697336648,1697343450,6802,5731,United Airlines,LAX,ORD
UA481,1697358946,1697361282,2336,7137,United Airlines,ORD,MKE
UA481,1697368767,1697376032,7265,16660,United Airlines,MKE,LAX
UA481,1697396570,1697406595,10025,16379,United Airlines,LAX,ORD
UA481,1697425540,1697431054,5514,14815,United Airlines,ORD,MKE
UA481,1697446671,1697452397,5726,14099,United Airlines,MKE,LAX
UA481,1697468777,1697472545,3768,11048,United Airlines,LAX,ORD
UA481,1697487767,1697490642,2875,17860,United Airlines,ORD,MKE
UA481,1697514588,1697524911,10323,17430,United Airlines,MKE,SFO
UA481,1697550086,1697552596,2510,9062,United Airlines,SFO,LAX
UA481,1697564908,1697572898,7990,6754,United Airlines,LAX,ORD
UA481,1697589740,1697592151,2411,8353,United Airlines,ORD,MKE
UA481,1697603667,1697606509,2842,6048,United Airlines,MKE,SFO
UA481,1697614219,1697622120,7901,9687,United Airlines,SFO,LAX
UA481,1697642420,1697645643,3223,13155,United Airlines,LAX,ORD
UA481,1697660226,1697667974,7748,17154,United Airlines,ORD,MKE
UA481,1697689921,1697697019,7098,12179,United Airlines,MKE,SFO
UA481,1697719677,1697723055,3378,17808,United Airlines,SFO,ORD
UA481,1697748359,1697750179,1820,7097,United Airlines,ORD,MKE
UA481,1697767182,1697773868,6686,9881,United Airlines,MKE,LAX
UA481,1697789559,1697794282,4723,18942,United Airlines,LAX,SFO
UA481,1697823363,1697832085,8722,5475,United Airlines,SFO,LAX
UA481,1697847430,1697855592,8162,13407,United Airlines,LAX,SFO
UA481,1697875617,1697882184,6567,18683,United Airlines,SFO,ORD
UA481,1697903688,1697913841,10153,17470,United Airlines,ORD,MKE
UA481,1697934112,1697940478,6366,21491,United Airlines,MKE,ORD
UA481,1697963692,1697969735,6043,14174,United Airlines,ORD,MKE
UA481,1697991640,1698001952,10312,8349,United Airlines,MKE,ORD
UA481,1698015291,1698025375,10084,11139,United Airlines,ORD,MKE
UA481,1698043880,1698046375,2495,14503,United Airlines,MKE,SFO
UA481,1698062143,1698070768,8625,16137,United Airlines,SFO,LAX
UA481,1698087750,1698090755,3005,18152,United Airlines,LAX,SFO
UA481,1698116591,1698122903,6312,21183,United Airlines,SFO,ORD
UA481,1698149176,1698151745,2569,19810,United Airlines,ORD,MKE
UA481,1698173625,1698179157,5532,6102,United Airlines,MKE,ORD
UA481,1698195341,1698198239,2898,9490,United Airlines,ORD,MKE
UA481,1698212023,1698221005,8982,5254,United Airlines,MKE,ORD
UA481,1698233802,1698238960,5158,15353,United Airlines,ORD,MKE
UA481,1698264556,1698270152,5596,20231,United Airlines,MKE,SFO
UA481,1698295886,1698302895,7009,10146,United Airlines,SFO,LAX
UA481,1698321736,1698328258,6522,14843,United Airlines,LAX,ORD
UA481,1698345490,1698355620,10130,9166,United Airlines,ORD,MKE
UA481,1698373395,1698376493,3098,9658,United Airlines,MKE,ORD
UA481,1698391654,1698393865,2211,7238,United Airlines,ORD,MKE
UA481,1698409270,1698414057,4787,13437,United Airlines,MKE,SFO
UA481,1698436065,1698446041,9976,10206,United Airlines,SFO,ORD
UA481,1698457018,1698465171,8153,11235,United Airlines,ORD,MKE
UA481,1698485335,1698496048,10713,10812,United Airlines,MKE,LAX
UA109,1682959659,1682966597,6938,4445,United Airlines,LAX,ORD
UA109,1682976006,1682982530,6524,4091,United Airlines,ORD,MKE
UA109,1682986863,1682995801,8938,14451,United Airlines,MKE,ORD
UA109,1683015176,1683025149,9973,12448,United Airlines,ORD,MKE
UA109,1683043433,1683052098,8665,15008,United Airlines,MKE,SFO
UA109,1683072451,1683077679,5228,10179,United Airlines,SFO,LAX
UA109,1683093881,1683102927,9046,13503,United Airlines,LAX,ORD
UA109,1683121371,1683131910,10539,9202,United Airlines,ORD,MKE
UA109,1683144569,1683149140,4571,10431,United Airlines,MKE,SFO
UA109,1683164836,1683170409,5573,9509,United Airlines,SFO,LAX
UA109,1683188463,1683190658,2195,5035,United Airlines,LAX,ORD
UA109,1683199613,1683206799,7186,9383,United Airlines,ORD,MKE
UA109,1683220864,1683225999,5135,6074,United Airlines,MKE,ORD
UA109,1683242812,1683244875,2063,16496,United Airlines,ORD,MKE
UA109,1683263425,1683266701,3276,13058,United Airlines,MKE,LAX
UA109,1683285339,1683292261,6922,5466,United Airlines,LAX,ORD
UA109,1683303398,1683314051,10653,19236,United Airlines,ORD,MKE
UA109,1683341359,1683345746,4387,18070,United Airlines,MKE,SFO
UA109,1683371093,1683377618,6525,10420,United Airlines,SFO,ORD
UA109,1683393265,1683402365,9100,5376,United Airlines,ORD,MKE
UA109,1683409322,1683412709,3387,7709,United Airlines,MKE,LAX
UA109,1683430286,1683435712,5426,21248,United Airlines,LAX,SFO
UA109,1683466593,1683473659,7066,21141,United Airlines,SFO,LAX
UA109,1683498166,1683507506,9340,18002,United Airlines,LAX,SFO
UA109,1683529630,1683537137,7507,3825,United Airlines,SFO,LAX
UA109,1683551051,1683559900,8849,5502,United Airlines,LAX,SFO
UA109,1683571288,1683577725,6437,18727,United Airlines,SFO,LAX
UA109,1683597340,1683600793,3453,21514,United Airlines,LAX,SFO
UA109,1683622475,1683626475,4000,9894,United Airlines,SFO,ORD
UA109,1683636747,1683639887,3140,4040,United Airlines,ORD,MKE
UA109,1683654161,1683662328,8167,10038,United Airlines,MKE,LAX
UA109,1683680250,1683685448,5198,19727,United Airlines,LAX,ORD
UA109,1683707142,1683711380,4238,12332,United Airlines,ORD,MKE
UA109,1683730141,1683736277,6136,7230,United Airlines,MKE,SFO
UA109,1683746691,1683754642,7951,10487,United Airlines,SFO,LAX
UA109,1683770841,1683776663,5822,17160,United Airlines,LAX,ORD
UA109,1683803318,1683807133,3815,5574,United Airlines,ORD,MKE
UA109,1683819226,1683826520,7294,11754,United Airlines,MKE,LAX
UA109,1683844876,1683847637,2761,10897,United Airlines,LAX,SFO
UA109,1683866491,1683870432,3941,13615,United Airlines,SFO,LAX
UA109,1683885612,1683892761,7149,17482,United Airlines,LAX,SFO
UA109,1683916126,1683926848,10722,13006,United Airlines,SFO,ORD
UA109,1683940995,1683950593,9598,15408,United Airlines,ORD,MKE
UA109,1683971526,1683973818,2292,5490,United Airlines,MKE,SFO
UA109,1683983448,1683987175,3727,20374,United Airlines,SFO,LAX
UA109,1684008002,1684017678,9676,8764,United Airlines,LAX,SFO
UA109,1684035884,1684042275,6391,18212,United Airlines,SFO,ORD
UA109,1684069148,1684073808,4660,21096,United Airlines,ORD,MKE
UA109,1684098168,1684103542,5374,4092,United Airlines,MKE,SFO
UA109,1684108154,1684117806,9652,13765,United Airlines,SFO,LAX
UA109,1684135778,1684139385,3607,11505,United Airlines,LAX,SFO
UA109,1684160095,1684166340,6245,20166,United Airlines,SFO,ORD
UA109,1684187190,1684191812,4622,13856,United Airlines,ORD,MKE
UA109,1684215150,1684218414,3264,15035,United Airlines,MKE,SFO
UA109,1684233847,1684242440,8593,11935,United Airlines,SFO,LAX
UA109,1684264102,1684274081,9979,5535,United Airlines,LAX,ORD
UA109,1684280071,1684286022,5951,6328,United Airlines,ORD,MKE
UA109,1684299005,1684305267,6262,5338,United Airlines,MKE,SFO
UA109,1684310711,1684320222,9511,16807,United Airlines,SFO,LAX
UA109,1684337224,1684344044,6820,10311,United Airlines,LAX,SFO
UA109,1684356037,1684361125,5088,14772,United Airlines,SFO,LAX
UA109,1684383698,1684391010,7312,15571,United Airlines,LAX,ORD
UA109,1684410277,1684419031,8754,17124,United Airlines,ORD,MKE
UA109,1684439458,1684445917,6459,5811,United Airlines,MKE,SFO
UA109,1684461758,1684464089,2331,4692,United Airlines,SFO,LAX
UA109,1684470353,1684474170,3817,20769,United Airlines,LAX,ORD
UA109,1684503971,1684508027,4056,20227,United Airlines,ORD,MKE
UA109,1684532431,1684536456,4025,20676,United Airlines,MKE,SFO
UA109,1684560452,1684566165,5713,19661,United Airlines,SFO,LAX
UA109,1684589334,1684591684,2350,18678,United Airlines,LAX,ORD
UA109,1684616302,1684618976,2674,10741,United Airlines,ORD,MKE
UA109,1684634270,1684638775,4505,17790,United Airlines,MKE,LAX
UA109,1684658451,1684662712,4261,19738,United Airlines,LAX,SFO
UA109,1684684912,1684689444,4532,5013,United Airlines,SFO,ORD
UA109,1684700762,1684704620,3858,12998,United Airlines,ORD,MKE
UA109,1684723634,1684728053,4419,21057,United Airlines,MKE,ORD
UA109,1684749665,1684757202,7537,17177,United Airlines,ORD,MKE
UA109,1684775133,1684782729,7596,12615,United Airlines,MKE,SFO
UA109,1684798003,1684808131,10128,19748,United Airlines,SFO,ORD
UA109,1684830333,1684833938,3605,13317,United Airlines,ORD,MKE
UA109,1684856037,1684857925,1888,19030,United Airlines,MKE,SFO
UA109,1684883676,1684888238,4562,4434,United Airlines,SFO,LAX
UA109,1684900519,1684911060,10541,6397,United Airlines,LAX,ORD
UA109,1684924140,1684934245,10105,10203,United Airlines,ORD,MKE
UA109,1684951789,1684958898,7109,4284,United Airlines,MKE,LAX
UA109,1684969180,1684977811,8631,6237,United Airlines,LAX,SFO
UA109,1684987011,1684994430,7419,3886,United Airlines,SFO,ORD
UA109,1685000058,1685002609,2551,18777,United Airlines,ORD,MKE
UA109,1685024611,1685032125,7514,17837,United Airlines,MKE,LAX
UA109,1685058261,1685067334,9073,13720,United Airlines,LAX,SFO
UA109,1685086943,1685088909,1966,20808,United Airlines,SFO,ORD
UA109,1685116404,1685119026,2622,18738,United Airlines,ORD,MKE
UA109,1685141875,1685145229,3354,4022,United Airlines,MKE,LAX
UA109,1685157237,1685163554,6317,10310,United Airlines,LAX,ORD
UA109,1685183713,1685186236,2523,11012,United Airlines,ORD,MKE
UA109,1685201274,1685211878,10604,6363,United Airlines,MKE,ORD
UA109,1685226360,1685228308,1948,11893,United Airlines,ORD,MKE
UA109,1685248784,1685258798,10014,20244,United Airlines,MKE,SFO
UA109,1685289529,1685291649,2120,7531,United Airlines,SFO,ORD
UA109,1685308992,1685311950,2958,6715,United Airlines,ORD,MKE
UA109,1685327354,1685334021,6667,15652,United Airlines,MKE,LAX
UA109,1685357349,1685365919,8570,4558,United Airlines,LAX,ORD
UA109,1685373936,1685380156,6220,15301,United Airlines,ORD,MKE
UA109,1685401396,1685409113,7717,17790,United Airlines,MKE,ORD
UA109,1685435723,1685443351,7628,19898,United Airlines,ORD,MKE
UA109,1685472103,1685477179,5076,14750,United Airlines,MKE,LAX
UA109,1685499555,1685510019,10464,19551,United Airlines,LAX,ORD
UA109,1685539164,1685546416,7252,11183,United Airlines,ORD,MKE
UA109,1685562823,1685567886,5063,21378,United Airlines,MKE,ORD
UA109,1685591865,1685596742,4877,17400,United Airlines,ORD,MKE
UA109,1685615395,1685622739,7344,7983,United Airlines,MKE,LAX
UA109,1685640554,1685643185,2631,13677,United Airlines,LAX,SFO
UA109,1685661870,1685665416,3546,4041,United Airlines,SFO,LAX
UA109,1685671895,1685682109,10214,4603,United Airlines,LAX,SFO
UA109,1685693107,1685695497,2390,13691,United Airlines,SFO,LAX
UA109,1685717295,1685727946,10651,7610,United Airlines,LAX,SFO
UA109,1685736919,1685741253,4334,7049,United Airlines,SFO,LAX
UA109,1685750117,1685753312,3195,15109,United Airlines,LAX,SFO
UA109,1685778876,1685788438,9562,7098,United Airlines,SFO,ORD
UA109,1685798024,1685804164,6140,16370,United Airlines,ORD,MKE
UA109,1685821217,1685825096,3879,7095,United Airlines,MKE,SFO
UA109,1685841953,1685850930,8977,18923,United Airlines,SFO,ORD
UA109,1685874816,1685877726,2910,6317,United Airlines,ORD,MKE
UA109,1685888395,1685895288,6893,12989,United Airlines,MKE,LAX
UA109,1685913266,1685921326,8060,16494,United Airlines,LAX,SFO
UA109,1685940405,1685946808,6403,9827,United Airlines,SFO,LAX
UA109,1685958190,1685961079,2889,21463,United Airlines,LAX,SFO
UA109,1685987461,1685993457,5996,21414,United Airlines,SFO,LAX
UA109,1686015576,1686023934,8358,9001,United Airlines,LAX,ORD
UA109,1686039709,1686047561,7852,12941,United Airlines,ORD,MKE
UA109,1686062087,1686072487,10400,14431,United Airlines,MKE,ORD
UA109,1686097627,1686099987,2360,12409,United Airlines,ORD,MKE
UA109,1686116544,1686125291,8747,21063,United Airlines,MKE,SFO
UA109,1686154644,1686161606,6962,4606,United Airlines,SFO,LAX
UA109,1686171509,1686175560,4051,13776,United Airlines,LAX,SFO
UA109,1686194649,1686200927,6278,17119,United Airlines,SFO,LAX
UA109,1686224853,1686233683,8830,16264,United Airlines,LAX,ORD
UA109,1686255018,1686263935,8917,12188,United Airlines,ORD,MKE
UA109,1686278815,1686289020,10205,17521,United Airlines,MKE,LAX
UA109,1686311152,1686318827,7675,3675,United Airlines,LAX,ORD
UA109,1686323356,1686327216,3860,4573,United Airlines,ORD,MKE
UA109,1686339013,1686347381,8368,11175,United Airlines,MKE,SFO
UA109,1686367266,1686369285,2019,6021,United Airlines,SFO,LAX
UA109,1686380736,1686383945,3209,4152,United Airlines,LAX,SFO
UA109,1686392119,1686396524,4405,16584,United Airlines,SFO,LAX
UA109,1686420759,1686423555,2796,12847,United Airlines,LAX,SFO
UA109,1686441095,1686450345,9250,12444,United Airlines,SFO,ORD
UA109,1686473251,1686480583,7332,15586,United Airlines,ORD,MKE
UA109,1686497933,1686500895,2962,20295,United Airlines,MKE,LAX
UA109,1686529595,1686531677,2082,14305,United Airlines,LAX,SFO
UA109,1686548006,1686555219,7213,9439,United Airlines,SFO,ORD
UA109,1686571375,1686580279,8904,8576,United Airlines,ORD,MKE
UA109,1686590423,1686599628,9205,12101,United Airlines,MKE,SFO
UA109,1686615087,1686619315,4228,16623,United Airlines,SFO,ORD
UA109,1686642143,1686647695,5552,18060,United Airlines,ORD,MKE
UA109,1686671112,1686674608,3496,13377,United Airlines,MKE,SFO
UA109,1686690137,1686697659,7522,17050,United Airlines,SFO,ORD
UA109,1686725124,1686734235,9111,14307,United Airlines,ORD,MKE
UA109,1686749544,1686753010,3466,3939,United Airlines,MKE,LAX
UA109,1686767003,1686774771,7768,6240,United Airlines,LAX,ORD
UA109,1686784004,1686794408,10404,7884,United Airlines,ORD,MKE
UA109,1686804028,1686807598,3570,4328,United Airlines,MKE,ORD
UA109,1686815112,1686821889,6777,8281,United Airlines,ORD,MKE
UA109,1686831935,1686840543,8608,17283,United Airlines,MKE,LAX
UA109,1686861733,1686869774,8041,12972,United Airlines,LAX,SFO
UA109,1686886568,1686891953,5385,10211,United Airlines,SFO,LAX
UA109,1686910218,1686915907,5689,15428,United Airlines,LAX,SFO
UA109,1686937242,1686946897,9655,5340,United Airlines,SFO,ORD
UA109,1686960000,1686970027,10027,18912,United Airlines,ORD,MKE
UA109,1686991963,1687000768,8805,17213,United Airlines,MKE,ORD
UA109,1687021978,1687025249,3271,16003,United Airlines,ORD,MKE
UA109,1687042315,1687050836,8521,12537,United Airlines,MKE,SFO
UA109,1687066373,1687069011,2638,21159,United Airlines,SFO,LAX
UA109,1687091922,1687101844,9922,7993,United Airlines,LAX,ORD
UA109,1687117106,1687125651,8545,10844,United Airlines,ORD,MKE
UA109,1687140015,1687150563,10548,19746,United Airlines,MKE,SFO
UA109,1687175315,1687183814,8499,17114,United Airlines,SFO,ORD
UA109,1687209865,1687218231,8366,19749,United Airlines,ORD,MKE
UA109,1687245465,1687248666,3201,9644,United Airlines,MKE,LAX
UA109,1687259841,1687263163,3322,10216,United Airlines,LAX,ORD
UA109,1687282922,1687293350,10428,11748,United Airlines,ORD,MKE
UA109,1687306758,1687315877,9119,12484,United Airlines,MKE,ORD
UA109,1687329829,1687339335,9506,9134,United Airlines,ORD,MKE
UA109,1687356031,1687364640,8609,19423,United Airlines,MKE,SFO
UA109,1687389328,1687395631,6303,14513,United Airlines,SFO,LAX
UA109,1687416528,1687423957,7429,7132,United Airlines,LAX,SFO
UA109,1687434018,1687443666,9648,3660,United Airlines,SFO,LAX
UA109,1687453336,1687455667,2331,10999,United Airlines,LAX,ORD
UA109,1687472531,1687478240,5709,14279,United Airlines,ORD,MKE
UA109,1687492774,1687496068,3294,13806,United Airlines,MKE,SFO
UA109,1687511963,1687514386,2423,16529,United Airlines,SFO,ORD
UA109,1687541203,1687544600,3397,19440,United Airlines,ORD,MKE
UA109,1687573451,1687578965,5514,16914,United Airlines,MKE,ORD
UA109,1687604271,1687608801,4530,4201,United Airlines,ORD,MKE
UA109,1687622642,1687630482,7840,6995,United Airlines,MKE,LAX
UA109,1687643014,1687646748,3734,19963,United Airlines,LAX,ORD
UA109,1687671997,1687675875,3878,11314,United Airlines,ORD,MKE
UA109,1687697545,1687702745,5200,4273,United Airlines,MKE,SFO
UA109,1687716739,1687726586,9847,14359,United Airlines,SFO,LAX
UA109,1687751676,1687754734,3058,16250,United Airlines,LAX,ORD
UA109,1687780563,1687786359,5796,14855,United Airlines,ORD,MKE
UA109,1687810804,1687817751,6947,5938,United Airlines,MKE,SFO
UA109,1687826877,1687836395,9518,20256,United Airlines,SFO,LAX
UA109,1687864436,1687868572,4136,21316,United Airlines,LAX,ORD
UA109,1687895158,1687905120,9962,3886,United Airlines,ORD,MKE
UA109,1687919763,1687922539,2776,19325,United Airlines,MKE,ORD
UA109,1687947329,1687950336,3007,6559,United Airlines,ORD,MKE
UA109,1687961761,1687968720,6959,15449,United Airlines,MKE,SFO
UA109,1687987500,1687993452,5952,12473,United Airlines,SFO,LAX
UA109,1688009878,1688014424,4546,11370,United Airlines,LAX,ORD
UA109,1688035802,1688041271,5469,7856,United Airlines,ORD,MKE
UA109,1688053295,1688059029,5734,13415,United Airlines,MKE,ORD
UA109,1688080478,1688083964,3486,15903,United Airlines,ORD,MKE
UA109,1688108381,1688111126,2745,19766,United Airlines,MKE,LAX
UA109,1688141325,1688151105,9780,5458,United Airlines,LAX,ORD
UA109,1688161702,1688165477,3775,11185,United Airlines,ORD,MKE
UA109,1688180104,1688186014,5910,9035,United Airlines,MKE,ORD
UA109,1688203463,1688211741,8278,21044,United Airlines,ORD,MKE
UA109,1688242624,1688249054,6430,4834,United Airlines,MKE,ORD
UA109,1688257673,1688267442,9769,15271,United Airlines,ORD,MKE
UA109,1688288517,1688298096,9579,12381,United Airlines,MKE,ORD
UA109,1688313604,1688322386,8782,21209,United Airlines,ORD,MKE
UA109,1688348620,1688358445,9825,4322,United Airlines,MKE,ORD
UA109,1688372866,1688380879,8013,21370,United Airlines,ORD,MKE
UA109,1688409329,1688412717,3388,3910,United Airlines,MKE,LAX
UA109,1688420467,1688427026,6559,8808,United Airlines,LAX,ORD
UA109,1688443676,1688450871,7195,10203,United Airlines,ORD,MKE
UA109,1688471422,1688473829,2407,12552,United Airlines,MKE,LAX
UA109,1688486860,1688491835,4975,17857,United Airlines,LAX,ORD
UA109,1688519431,1688522788,3357,21505,United Airlines,ORD,MKE
UA109,1688553109,1688560601,7492,7322,United Airlines,MKE,LAX
UA109,1688575967,1688586537,10570,9862,United Airlines,LAX,ORD
UA109,1688597495,1688605052,7557,10924,United Airlines,ORD,MKE
UA109,1688619284,1688629598,10314,9283,United Airlines,MKE,SFO
UA109,1688647537,1688655299,7762,14292,United Airlines,SFO,LAX
UA109,1688674704,1688677356,2652,18638,United Airlines,LAX,SFO
UA109,1688703572,1688711919,8347,18233,United Airlines,SFO,LAX
UA109,1688731150,1688736622,5472,4849,United Airlines,LAX,ORD
UA109,1688741953,1688749230,7277,7783,United Airlines,ORD,MKE
UA109,1688766415,1688776636,10221,18284,United Airlines,MKE,ORD
UA109,1688802307,1688804273,1966,5323,United Airlines,ORD,MKE
UA109,1688814273,1688816204,1931,15540,United Airlines,MKE,LAX
UA109,1688837550,1688845804,8254,20808,United Airlines,LAX,ORD
UA109,1688876196,1688882572,6376,9251,United Airlines,ORD,MKE
UA109,1688901399,1688910192,8793,9921,United Airlines,MKE,ORD
UA109,1688928659,1688934667,6008,8762,United Airlines,ORD,MKE
UA109,1688954075,1688957384,3309,8536,United Airlines,MKE,SFO
UA109,1688976681,1688980690,4009,7345,United Airlines,SFO,ORD
UA109,1688997284,1689005379,8095,13515,United Airlines,ORD,MKE
UA109,1689027536,1689034333,6797,12656,United Airlines,MKE,LAX
UA109,1689050845,1689059671,8826,4990,United Airlines,LAX,SFO
UA109,1689074843,1689082508,7665,21051,United Airlines,SFO,ORD
UA109,1689109720,1689112417,2697,7474,United Airlines,ORD,MKE
UA109,1689123089,1689126390,3301,10625,United Airlines,MKE,ORD
UA109,1689145725,1689150593,4868,8783,United Airlines,ORD,MKE
UA109,1689169702,1689173057,3355,10623,United Airlines,MKE,SFO
UA109,1689192784,1689195240,2456,8227,United Airlines,SFO,ORD
UA109,1689208103,1689211354,3251,12282,United Airlines,ORD,MKE
UA109,1689233126,1689243337,10211,20596,United Airlines,MKE,ORD
UA109,1689269211,1689272253,3042,11727,United Airlines,ORD,MKE
UA109,1689289923,1689296666,6743,8185,United Airlines,MKE,LAX
UA109,1689313004,1689315250,2246,14501,United Airlines,LAX,SFO
UA109,1689331974,1689342254,10280,14847,United Airlines,SFO,ORD
UA109,1689360498,1689366233,5735,17986,United Airlines,ORD,MKE
UA109,1689387066,1689393270,6204,19208,United Airlines,MKE,LAX
UA109,1689413923,1689420716,6793,19080,United Airlines,LAX,ORD
UA109,1689448462,1689450536,2074,3938,United Airlines,ORD,MKE
UA109,1689457848,1689466404,8556,5886,United Airlines,MKE,ORD
UA109,1689480849,1689487405,6556,4962,United Airlines,ORD,MKE
UA109,1689493653,1689497079,3426,6532,United Airlines,MKE,SFO
UA109,1689509895,1689512951,3056,12532,United Airlines,SFO,LAX
UA109,1689534626,1689542462,7836,5548,United Airlines,LAX,SFO
UA109,1689556077,1689564547,8470,4961,United Airlines,SFO,ORD
UA109,1689572236,1689575552,3316,21159,United Airlines,ORD,MKE
UA109,1689598596,1689607003,8407,6693,United Airlines,MKE,LAX
UA109,1689619780,1689626796,7016,4166,United Airlines,LAX,SFO
UA109,1689640830,1689651168,10338,11883,United Airlines,SFO,LAX
UA109,1689671053,1689675093,4040,21101,United Airlines,LAX,SFO
UA109,1689702683,1689708778,6095,21461,United Airlines,SFO,LAX
UA109,1689730755,1689736448,5693,3901,United Airlines,LAX,ORD
UA109,1689743407,1689749933,6526,17943,United Airlines,ORD,MKE
UA109,1689768777,1689776629,7852,8388,United Airlines,MKE,LAX
UA109,1689787311,1689793038,5727,7461,United Airlines,LAX,ORD
UA109,1689808910,1689819491,10581,5138,United Airlines,ORD,MKE
UA109,1689825063,1689828414,3351,4006,United Airlines,MKE,LAX
UA109,1689841665,1689844155,2490,9442,United Airlines,LAX,ORD
UA109,1689855765,1689858983,3218,9101,United Airlines,ORD,MKE
UA109,1689877882,1689888250,10368,13418,United Airlines,MKE,LAX
UA109,1689911331,1689921802,10471,10032,United Airlines,LAX,ORD
UA109,1689932799,1689937588,4789,17050,United Airlines,ORD,MKE
UA109,1689957237,1689963591,6354,14108,United Airlines,MKE,SFO
UA109,1689987347,1689997991,10644,17864,United Airlines,SFO,ORD
UA109,1690017855,1690019781,1926,18744,United Airlines,ORD,MKE
UA109,1690047617,1690052225,4608,6616,United Airlines,MKE,LAX
UA109,1690069413,1690076643,7230,12433,United Airlines,LAX,ORD
UA109,1690099058,1690107562,8504,7465,United Airlines,ORD,MKE
UA109,1690123839,1690127663,3824,11100,United Airlines,MKE,ORD
UA109,1690145114,1690154696,9582,10464,United Airlines,ORD,MKE
UA109,1690174772,1690181078,6306,8339,United Airlines,MKE,SFO
UA109,1690194957,1690202093,7136,13881,United Airlines,SFO,LAX
UA109,1690224576,1690228012,3436,5701,United Airlines,LAX,SFO
UA109,1690235454,1690244575,9121,11097,United Airlines,SFO,ORD
UA109,1690256937,1690263526,6589,18013,United Airlines,ORD,MKE
UA109,1690290791,1690299388,8597,9058,United Airlines,MKE,LAX
UA109,1690314452,1690318815,4363,14204,United Airlines,LAX,ORD
UA109,1690335276,1690345145,9869,20008,United Airlines,ORD,MKE
UA109,1690374148,1690383419,9271,11059,United Airlines,MKE,ORD
UA109,1690397559,1690405685,8126,12950,United Airlines,ORD,MKE
UA109,1690424683,1690426604,1921,19945,United Airlines,MKE,LAX
UA109,1690447906,1690452987,5081,4336,United Airlines,LAX,ORD
UA109,1690462006,1690472077,10071,11839,United Airlines,ORD,MKE
UA109,1690490064,1690493200,3136,20202,United Airlines,MKE,LAX
UA109,1690518697,1690527511,8814,16105,United Airlines,LAX,ORD
UA109,1690550222,1690553012,2790,17447,United Airlines,ORD,MKE
UA109,1690579141,1690581794,2653,18118,United Airlines,MKE,SFO
UA109,1690603476,1690607507,4031,9337,United Airlines,SFO,LAX
UA109,1690623443,1690630127,6684,3853,United Airlines,LAX,ORD
UA109,1690643862,1690653464,9602,11998,United Airlines,ORD,MKE
UA109,1690671510,1690675897,4387,18434,United Airlines,MKE,ORD
UA109,1690697515,1690701454,3939,7602,United Airlines,ORD,MKE
UA109,1690715416,1690723244,7828,7567,United Airlines,MKE,ORD
UA109,1690734644,1690738337,3693,10877,United Airlines,ORD,MKE
UA109,1690756442,1690766156,9714,20443,United Airlines,MKE,SFO
UA109,1690788253,1690794030,5777,21416,United Airlines,SFO,LAX
UA109,1690826152,1690829611,3459,3805,United Airlines,LAX,SFO
UA109,1690835503,1690845498,9995,12708,United Airlines,SFO,LAX
UA109,1690868537,1690876614,8077,20232,United Airlines,LAX,SFO
UA109,1690905023,1690915214,10191,14548,United Airlines,SFO,ORD
UA109,1690930992,1690934739,3747,11227,United Airlines,ORD,MKE
UA109,1690948229,1690953069,4840,18568,United Airlines,MKE,SFO
UA109,1690975800,1690986092,10292,15231,United Airlines,SFO,ORD
UA109,1691002516,1691006185,3669,12861,United Airlines,ORD,MKE
UA109,1691026080,1691029371,3291,5042,United Airlines,MKE,LAX
UA109,1691042229,1691046264,4035,10953,United Airlines,LAX,SFO
UA109,1691060900,1691066568,5668,18344,United Airlines,SFO,LAX
UA109,1691085519,1691089718,4199,18981,United Airlines,LAX,ORD
UA109,1691110046,1691112038,1992,11829,United Airlines,ORD,MKE
UA109,1691128281,1691133696,5415,11606,United Airlines,MKE,LAX
UA109,1691155759,1691165725,9966,7480,United Airlines,LAX,ORD
UA109,1691182462,1691186060,3598,5037,United Airlines,ORD,MKE
UA109,1691195800,1691198051,2251,19635,United Airlines,MKE,ORD
UA109,1691219999,1691225955,5956,6516,United Airlines,ORD,MKE
UA109,1691235893,1691244161,8268,18553,United Airlines,MKE,ORD
UA109,1691263042,1691266306,3264,15010,United Airlines,ORD,MKE
UA109,1691286385,1691293022,6637,14053,United Airlines,MKE,SFO
UA109,1691316290,1691324908,8618,15629,United Airlines,SFO,LAX
UA109,1691349042,1691351463,2421,14888,United Airlines,LAX,ORD
UA109,1691376101,1691382125,6024,9043,United Airlines,ORD,MKE
UA109,1691394130,1691398224,4094,9357,United Airlines,MKE,ORD
UA109,1691416808,1691424984,8176,10582,United Airlines,ORD,MKE
UA109,1691437079,1691440438,3359,11344,United Airlines,MKE,SFO
UA109,1691459153,1691467180,8027,21392,United Airlines,SFO,ORD
UA109,1691490207,1691495281,5074,5347,United Airlines,ORD,MKE
UA109,1691500914,1691510868,9954,12437,United Airlines,MKE,ORD
UA109,1691526463,1691530122,3659,4443,United Airlines,ORD,MKE
UA109,1691541480,1691552200,10720,17851,United Airlines,MKE,ORD
UA109,1691575308,1691580454,5146,13774,United Airlines,ORD,MKE
UA109,1691600669,1691608322,7653,5040,United Airlines,MKE,ORD
UA109,1691618238,1691629035,10797,12557,United Airlines,ORD,MKE
UA109,1691643799,1691651664,7865,5393,United Airlines,MKE,LAX
UA109,1691659079,1691661117,2038,9080,United Airlines,LAX,SFO
UA109,1691671811,1691680109,8298,19103,United Airlines,SFO,LAX
UA109,1691707974,1691711505,3531,6764,United Airlines,LAX,ORD
UA109,1691725963,1691731831,5868,13604,United Airlines,ORD,MKE
UA109,1691748082,1691752733,4651,14005,United Airlines,MKE,LAX
UA109,1691770392,1691780022,9630,9911,United Airlines,LAX,ORD
UA109,1691792005,1691797825,5820,17394,United Airlines,ORD,MKE
UA109,1691824916,1691827378,2462,19311,United Airlines,MKE,ORD
UA109,1691850405,1691857616,7211,13954,United Airlines,ORD,MKE
UA109,1691873184,1691877272,4088,14748,United Airlines,MKE,ORD
UA109,1691896158,1691898496,2338,11571,United Airlines,ORD,MKE
UA109,1691917881,1691920401,2520,11892,United Airlines,MKE,SFO
UA109,1691942629,1691952591,9962,9681,United Airlines,SFO,ORD
UA109,1691964132,1691972407,8275,3985,United Airlines,ORD,MKE
UA109,1691983541,1691986499,2958,18096,United Airlines,MKE,LAX
UA109,1692005687,1692015188,9501,8081,United Airlines,LAX,ORD
UA109,1692028284,1692038058,9774,13215,United Airlines,ORD,MKE
UA109,1692060398,1692066133,5735,9712,United Airlines,MKE,SFO
UA109,1692086438,1692095972,9534,15901,United Airlines,SFO,ORD
UA109,1692122536,1692128781,6245,11628,United Airlines,ORD,MKE
UA109,1692151008,1692152871,1863,15796,United Airlines,MKE,ORD
UA109,1692178932,1692189269,10337,15030,United Airlines,ORD,MKE
UA109,1692204404,1692214241,9837,20812,United Airlines,MKE,LAX
UA109,1692240328,1692244241,3913,4741,United Airlines,LAX,ORD
UA109,1692251211,1692259035,7824,10357,United Airlines,ORD,MKE
UA109,1692274663,1692277241,2578,11061,United Airlines,MKE,SFO
UA109,1692297165,1692303294,6129,17784,United Airlines,SFO,ORD
UA109,1692324663,1692333914,9251,6120,United Airlines,ORD,MKE
UA109,1692347854,1692354652,6798,17133,United Airlines,MKE,SFO
UA109,1692373424,1692383486,10062,10438,United Airlines,SFO,LAX
UA109,1692401390,1692409481,8091,12441,United Airlines,LAX,SFO
UA109,1692431456,1692435284,3828,18052,United Airlines,SFO,LAX
UA109,1692457104,1692467509,10405,18431,United Airlines,LAX,SFO
UA109,1692495020,1692501553,6533,5531,United Airlines,SFO,ORD
UA109,1692509690,1692514222,4532,5081,United Airlines,ORD,MKE
UA109,1692527255,1692533312,6057,12349,United Airlines,MKE,LAX
UA109,1692548817,1692554668,5851,14554,United Airlines,LAX,SFO
UA109,1692575520,1692578223,2703,19447,United Airlines,SFO,ORD
UA109,1692605191,1692612920,7729,11659,United Airlines,ORD,MKE
UA109,1692634813,1692639913,5100,13774,United Airlines,MKE,SFO
UA109,1692660161,1692667011,6850,15119,United Airlines,SFO,ORD
UA109,1692690934,1692701197,10263,8293,United Airlines,ORD,MKE
UA109,1692716813,1692719210,2397,11864,United Airlines,MKE,SFO
UA109,1692741055,1692751478,10423,8655,United Airlines,SFO,ORD
UA109,1692760405,1692764246,3841,16434,United Airlines,ORD,MKE
UA109,1692788386,1692795597,7211,3815,United Airlines,MKE,LAX
UA109,1692803940,1692811618,7678,6875,United Airlines,LAX,ORD
UA109,1692818979,1692824177,5198,18000,United Airlines,ORD,MKE
UA109,1692844108,1692845956,1848,11437,United Airlines,MKE,SFO
UA109,1692867936,1692872310,4374,13229,United Airlines,SFO,LAX
UA109,1692890294,1692899637,9343,8664,United Airlines,LAX,SFO
UA109,1692908447,1692918801,10354,3614,United Airlines,SFO,ORD
UA109,1692929999,1692939619,9620,7171,United Airlines,ORD,MKE
UA109,1692950016,1692954335,4319,18460,United Airlines,MKE,SFO
UA109,1692975722,1692985351,9629,16557,United Airlines,SFO,LAX
UA109,1693008212,1693013175,4963,6623,United Airlines,LAX,ORD
UA109,1693021432,1693025626,4194,16259,United Airlines,ORD,MKE
UA109,1693049747,1693053641,3894,20388,United Airlines,MKE,LAX
UA109,1693078064,1693080528,2464,21115,United Airlines,LAX,ORD
UA109,1693107766,1693117095,9329,5995,United Airlines,ORD,MKE
UA109,1693128584,1693138233,9649,18106,United Airlines,MKE,ORD
UA109,1693166429,1693170732,4303,10218,United Airlines,ORD,MKE
UA109,1693181415,1693188246,6831,10125,United Airlines,MKE,ORD
UA109,1693201667,1693211465,9798,15540,United Airlines,ORD,MKE
UA109,1693235880,1693244521,8641,14789,United Airlines,MKE,SFO
UA109,1693267193,1693272385,5192,9930,United Airlines,SFO,ORD
UA109,1693284883,1693289114,4231,7068,United Airlines,ORD,MKE
UA109,1693303473,1693308605,5132,13835,United Airlines,MKE,SFO
UA109,1693330326,1693335137,4811,11508,United Airlines,SFO,LAX
UA109,1693354513,1693363537,9024,11781,United Airlines,LAX,SFO
UA109,1693378718,1693385697,6979,19720,United Airlines,SFO,LAX
UA109,1693415235,1693421081,5846,10924,United Airlines,LAX,ORD
UA109,1693437673,1693446394,8721,19864,United Airlines,ORD,MKE
UA109,1693468671,1693473895,5224,3668,United Airlines,MKE,SFO
UA109,1693482722,1693493067,10345,5003,United Airlines,SFO,ORD
UA109,1693502866,1693506616,3750,11157,United Airlines,ORD,MKE
UA109,1693520732,1693527659,6927,19071,United Airlines,MKE,ORD
UA109,1693549354,1693556297,6943,15084,United Airlines,ORD,MKE
UA109,1693574509,1693580260,5751,12767,United Airlines,MKE,LAX
UA109,1693598213,1693606877,8664,20016,United Airlines,LAX,ORD
UA109,1693629396,1693638514,9118,19617,United Airlines,ORD,MKE
UA109,1693658258,1693666880,8622,13008,United Airlines,MKE,ORD
UA109,1693688352,1693694995,6643,11203,United Airlines,ORD,MKE
UA109,1693711026,1693714858,3832,17464,United Airlines,MKE,SFO
UA109,1693742566,1693746168,3602,17378,United Airlines,SFO,LAX
UA109,1693765104,1693766931,1827,4303,United Airlines,LAX,SFO
UA109,1693781702,1693791603,9901,15551,United Airlines,SFO,LAX
UA109,1693815020,1693819170,4150,10623,United Airlines,LAX,ORD
UA109,1693837039,1693842322,5283,19022,United Airlines,ORD,MKE
UA109,1693870134,1693874659,4525,15900,United Airlines,MKE,ORD
UA109,1693893568,1693903070,9502,12313,United Airlines,ORD,MKE
UA109,1693917260,1693920075,2815,5089,United Airlines,MKE,SFO
UA109,1693934948,1693942908,7960,12257,United Airlines,SFO,ORD
UA109,1693959981,1693962942,2961,17490,United Airlines,ORD,MKE
UA109,1693986397,1693996796,10399,10668,United Airlines,MKE,ORD
UA109,1694009117,1694012588,3471,9263,United Airlines,ORD,MKE
UA109,1694028441,1694036364,7923,10461,United Airlines,MKE,LAX
UA109,1694053884,1694057563,3679,9932,United Airlines,LAX,SFO
UA109,1694077688,1694086437,8749,20552,United Airlines,SFO,ORD
UA109,1694111640,1694117853,6213,20349,United Airlines,ORD,MKE
UA109,1694145677,1694154643,8966,13323,United Airlines,MKE,LAX
UA109,1694169562,1694172969,3407,5850,United Airlines,LAX,SFO
UA109,1694180979,1694189104,8125,18768,United Airlines,SFO,ORD
UA109,1694209123,1694218487,9364,9211,United Airlines,ORD,MKE
UA109,1694232418,1694242191,9773,9940,United Airlines,MKE,ORD
UA109,1694257251,1694267667,10416,5745,United Airlines,ORD,MKE
UA109,1694279428,1694286105,6677,18764,United Airlines,MKE,LAX
UA109,1694314312,1694318002,3690,13441,United Airlines,LAX,SFO
UA109,1694339580,1694349371,9791,8726,United Airlines,SFO,ORD
UA109,1694360940,1694368832,7892,11394,United Airlines,ORD,MKE
UA109,1694383239,1694386105,2866,8834,United Airlines,MKE,LAX
UA109,1694399582,1694408170,8588,16556,United Airlines,LAX,SFO
UA109,1694434860,1694441493,6633,15807,United Airlines,SFO,ORD
UA109,1694461542,1694468342,6800,11540,United Airlines,ORD,MKE
UA109,1694482379,1694485318,2939,15085,United Airlines,MKE,SFO
UA109,1694507298,1694516982,9684,7069,United Airlines,SFO,LAX
UA109,1694529682,1694534054,4372,18510,United Airlines,LAX,ORD
UA109,1694562340,1694570341,8001,21236,United Airlines,ORD,MKE
UA109,1694594760,1694598674,3914,16339,United Airlines,MKE,LAX
UA109,1694621871,1694630132,8261,14150,United Airlines,LAX,ORD
UA109,1694648084,1694658124,10040,8531,United Airlines,ORD,MKE
UA109,1694670551,1694679606,9055,8737,United Airlines,MKE,SFO
UA109,1694691631,1694697392,5761,10315,United Airlines,SFO,ORD
UA109,1694710236,1694714259,4023,16822,United Airlines,ORD,MKE
UA109,1694740334,1694747966,7632,3685,United Airlines,MKE,LAX
UA109,1694753688,1694762574,8886,9867,United Airlines,LAX,SFO
UA109,1694782160,1694787370,5210,3706,United Airlines,SFO,LAX
UA109,1694801167,1694803275,2108,20100,United Airlines,LAX,SFO
UA109,1694827237,1694833640,6403,13500,United Airlines,SFO,LAX
UA109,1694851773,1694854108,2335,14827,United Airlines,LAX,SFO
UA109,1694876400,1694880729,4329,10333,United Airlines,SFO,ORD
UA109,1694899509,1694902384,2875,7864,United Airlines,ORD,MKE
UA109,1694916569,1694923954,7385,20238,United Airlines,MKE,ORD
UA109,1694945378,1694948200,2822,8074,United Airlines,ORD,MKE
UA109,1694957668,1694965422,7754,8650,United Airlines,MKE,SFO
UA109,1694974167,1694982797,8630,11249,United Airlines,SFO,ORD
UA109,1694999151,1695006266,7115,19814,United Airlines,ORD,MKE
UA109,1695030002,1695040256,10254,15821,United Airlines,MKE,LAX
UA109,1695063633,1695068277,4644,4731,United Airlines,LAX,SFO
UA109,1695073018,1695075564,2546,8569,United Airlines,SFO,LAX
UA109,1695089095,1695094409,5314,12913,United Airlines,LAX,ORD
UA109,1695115771,1695118286,2515,13687,United Airlines,ORD,MKE
UA109,1695140538,1695150499,9961,9836,United Airlines,MKE,LAX
UA109,1695163144,1695173113,9969,15351,United Airlines,LAX,SFO
UA109,1695193354,1695199997,6643,9479,United Airlines,SFO,ORD
UA109,1695214598,1695220021,5423,17362,United Airlines,ORD,MKE
UA109,1695243496,1695251366,7870,12752,United Airlines,MKE,LAX
UA109,1695273953,1695282768,8815,18552,United Airlines,LAX,SFO
UA109,1695302864,1695310333,7469,10266,United Airlines,SFO,LAX
UA109,1695325504,1695333522,8018,16347,United Airlines,LAX,ORD
UA109,1695350578,1695354804,4226,13558,United Airlines,ORD,MKE
UA109,1695372536,1695378308,5772,4927,United Airlines,MKE,SFO
UA109,1695385747,1695389126,3379,3839,United Airlines,SFO,LAX
UA109,1695397878,1695403111,5233,11671,United Airlines,LAX,ORD
UA109,1695418379,1695420979,2600,7835,United Airlines,ORD,MKE
UA109,1695435781,1695443016,7235,19389,United Airlines,MKE,SFO
UA109,1695466521,1695470069,3548,11296,United Airlines,SFO,LAX
UA109,1695484279,1695486806,2527,14872,United Airlines,LAX,SFO
UA109,1695509858,1695514990,5132,15445,United Airlines,SFO,ORD
UA109,1695535855,1695542883,7028,8622,United Airlines,ORD,MKE
UA109,1695552598,1695557307,4709,14146,United Airlines,MKE,SFO
UA109,1695578951,1695581966,3015,15962,United Airlines,SFO,ORD
UA109,1695604598,1695606999,2401,12278,United Airlines,ORD,MKE
UA109,1695628975,1695633474,4499,12110,United Airlines,MKE,LAX
UA109,1695652199,1695660852,8653,6614,United Airlines,LAX,SFO
UA109,1695668774,1695675234,6460,4771,United Airlines,SFO,LAX
UA109,1695687601,1695698291,10690,14488,United Airlines,LAX,SFO
UA109,1695720321,1695725921,5600,20685,United Airlines,SFO,ORD
UA109,1695754109,1695762059,7950,14162,United Airlines,ORD,MKE
UA109,1695784009,1695792763,8754,12923,United Airlines,MKE,SFO
UA109,1695814997,1695819510,4513,3856,United Airlines,SFO,LAX
UA109,1695833074,1695835526,2452,7967,United Airlines,LAX,SFO
UA109,1695849250,1695858873,9623,7982,United Airlines,SFO,LAX
UA109,1695877520,1695885752,8232,17230,United Airlines,LAX,SFO
UA109,1695907524,1695915470,7946,10619,United Airlines,SFO,LAX
UA109,1695926521,1695935664,9143,10833,United Airlines,LAX,ORD
UA109,1695950265,1695957935,7670,19462,United Airlines,ORD,MKE
UA109,1695985116,1695988984,3868,19585,United Airlines,MKE,ORD
UA109,1696016188,1696022229,6041,13183,United Airlines,ORD,MKE
UA109,1696035839,1696040706,4867,11315,United Airlines,MKE,ORD
UA109,1696056490,1696058982,2492,12299,United Airlines,ORD,MKE
UA109,1696078824,1696084416,5592,9072,United Airlines,MKE,ORD
UA109,1696099153,1696101224,2071,17236,United Airlines,ORD,MKE
UA109,1696125305,1696127378,2073,10953,United Airlines,MKE,ORD
UA109,1696144679,1696146689,2010,17495,United Airlines,ORD,MKE
UA109,1696173938,1696180553,6615,11200,United Airlines,MKE,SFO
UA109,1696195479,1696201856,6377,12383,United Airlines,SFO,ORD
UA109,1696224893,1696233287,8394,18472,United Airlines,ORD,MKE
UA109,1696252018,1696259074,7056,17421,United Airlines,MKE,LAX
UA109,1696282767,1696288492,5725,4420,United Airlines,LAX,ORD
UA109,1696295230,1696298973,3743,11820,United Airlines,ORD,MKE
UA109,1696316166,1696324862,8696,13045,United Airlines,MKE,SFO
UA109,1696341339,1696345807,4468,9436,United Airlines,SFO,LAX
UA109,1696361021,1696363734,2713,7522,United Airlines,LAX,ORD
UA109,1696374887,1696381739,6852,14652,United Airlines,ORD,MKE
UA109,1696401952,1696407093,5141,21494,United Airlines,MKE,ORD
UA109,1696430101,1696440506,10405,3759,United Airlines,ORD,MKE
UA109,1696449555,1696456900,7345,5626,United Airlines,MKE,LAX
UA109,1696470294,1696480858,10564,17670,United Airlines,LAX,SFO
UA109,1696501178,1696510629,9451,6661,United Airlines,SFO,ORD
UA109,1696520402,1696524783,4381,18184,United Airlines,ORD,MKE
UA109,1696546723,1696550776,4053,16956,United Airlines,MKE,SFO
UA109,1696569949,1696578098,8149,12624,United Airlines,SFO,LAX
UA109,1696600089,1696608032,7943,13263,United Airlines,LAX,SFO
UA109,1696631514,1696638477,6963,8639,United Airlines,SFO,LAX
UA109,1696650513,1696656289,5776,19033,United Airlines,LAX,ORD
UA109,1696684063,1696691353,7290,11873,United Airlines,ORD,MKE
UA109,1696712159,1696717842,5683,4860,United Airlines,MKE,SFO
UA109,1696724324,1696728105,3781,16461,United Airlines,SFO,LAX
UA109,1696752408,1696754793,2385,4562,United Airlines,LAX,SFO
UA109,1696760827,1696771460,10633,7490,United Airlines,SFO,LAX
UA109,1696787972,1696793410,5438,4458,United Airlines,LAX,ORD
UA109,1696807502,1696813847,6345,7851,United Airlines,ORD,MKE
UA109,1696831142,1696837277,6135,19938,United Airlines,MKE,LAX
UA109,1696863867,1696867781,3914,12821,United Airlines,LAX,SFO
UA109,1696884123,1696889522,5399,8672,United Airlines,SFO,ORD
UA109,1696903859,1696907456,3597,21024,United Airlines,ORD,MKE
UA109,1696934110,1696940192,6082,15642,United Airlines,MKE,ORD
UA109,1696966611,1696968456,1845,17093,United Airlines,ORD,MKE
UA109,1696989044,1696999350,10306,7698,United Airlines,MKE,ORD
UA109,1697013111,1697015214,2103,16131,United Airlines,ORD,MKE
UA109,1697032183,1697038224,6041,8613,United Airlines,MKE,SFO
UA109,1697055764,1697064636,8872,17221,United Airlines,SFO,ORD
UA109,1697086656,1697093697,7041,4456,United Airlines,ORD,MKE
UA109,1697104865,1697111556,6691,16304,United Airlines,MKE,LAX
UA109,1697128962,1697132317,3355,9823,United Airlines,LAX,ORD
UA109,1697147174,1697153578,6404,3908,United Airlines,ORD,MKE
UA109,1697162811,1697173576,10765,4992,United Airlines,MKE,LAX
UA109,1697181624,1697188841,7217,17127,United Airlines,LAX,ORD
UA109,1697207850,1697217912,10062,19687,United Airlines,ORD,MKE
UA109,1697239757,1697247177,7420,10583,United Airlines,MKE,SFO
UA109,1697259892,1697263349,3457,4918,United Airlines,SFO,LAX
UA109,1697270753,1697274775,4022,7451,United Airlines,LAX,ORD
UA109,1697291152,1697299657,8505,9841,United Airlines,ORD,MKE
UA109,1697313238,1697322438,9200,5911,United Airlines,MKE,LAX
UA109,1697334948,1697345018,10070,9703,United Airlines,LAX,ORD
UA109,1697356747,1697362823,6076,14007,United Airlines,ORD,MKE
UA109,1697380677,1697389320,8643,9592,United Airlines,MKE,LAX
UA109,1697407453,1697416859,9406,14903,United Airlines,LAX,ORD
UA109,1697441665,1697450045,8380,16188,United Airlines,ORD,MKE
UA109,1697469634,1697472555,2921,18143,United Airlines,MKE,LAX
UA109,1697499951,1697507965,8014,16645,United Airlines,LAX,ORD
UA109,1697534747,1697543070,8323,14770,United Airlines,ORD,MKE
UA109,1697562761,1697568613,5852,19405,United Airlines,MKE,ORD
UA109,1697592543,1697601515,8972,17647,United Airlines,ORD,MKE
UA109,1697626554,1697636596,10042,6964,United Airlines,MKE,SFO
UA109,1697648443,1697653090,4647,11820,United Airlines,SFO,ORD
UA109,1697675201,1697677489,2288,9306,United Airlines,ORD,MKE
UA109,1697687652,1697697477,9825,9653,United Airlines,MKE,ORD
UA109,1697714964,1697721576,6612,8452,United Airlines,ORD,MKE
UA109,1697737102,1697740292,3190,6210,United Airlines,MKE,LAX
UA109,1697756614,1697764019,7405,20848,United Airlines,LAX,SFO
UA109,1697785825,1697796264,10439,5996,United Airlines,SFO,LAX
UA109,1697805908,1697807877,1969,8399,United Airlines,LAX,SFO
UA109,1697819017,1697820838,1821,10914,United Airlines,SFO,LAX
UA109,1697834501,1697841865,7364,12848,United Airlines,LAX,SFO
UA109,1697864948,1697874954,10006,8578,United Airlines,SFO,LAX
UA109,1697887615,1697896374,8759,21120,United Airlines,LAX,SFO
UA109,1697920513,1697924600,4087,10357,United Airlines,SFO,LAX
UA109,1697945142,1697955911,10769,4779,United Airlines,LAX,SFO
UA109,1697961770,1697972325,10555,9326,United Airlines,SFO,LAX
UA109,1697983336,1697988674,5338,13229,United Airlines,LAX,SFO
UA109,1698003549,1698006038,2489,21524,United Airlines,SFO,ORD
UA109,1698037736,1698042098,4362,18021,United Airlines,ORD,MKE
UA109,1698069112,1698077303,8191,13281,United Airlines,MKE,LAX
UA109,1698092439,1698102818,10379,20565,United Airlines,LAX,ORD
UA109,1698129213,1698135202,5989,21144,United Airlines,ORD,MKE
UA109,1698158328,1698163520,5192,19825,United Airlines,MKE,LAX
UA109,1698185299,1698187313,2014,20757,United Airlines,LAX,ORD
UA109,1698210518,1698214254,3736,10327,United Airlines,ORD,MKE
UA109,1698227766,1698233205,5439,6775,United Airlines,MKE,LAX
UA109,1698246494,1698254252,7758,19550,United Airlines,LAX,ORD
UA109,1698274770,1698283340,8570,10020,United Airlines,ORD,MKE
UA109,1698296160,1698301284,5124,14528,United Airlines,MKE,LAX
UA109,1698322077,1698330638,8561,14968,United Airlines,LAX,SFO
UA109,1698348163,1698351997,3834,4929,United Airlines,SFO,LAX
UA109,1698365354,1698375021,9667,10979,United Airlines,LAX,SFO
UA109,1698387190,1698397697,10507,16293,United Airlines,SFO,LAX
UA109,1698414804,1698417942,3138,10301,United Airlines,LAX,SFO
UA109,1698431738,1698438900,7162,8304,United Airlines,SFO,LAX
UA109,1698455733,1698464001,8268,17341,United Airlines,LAX,ORD
UA109,1698483196,1698487318,4122,18238,United Airlines,ORD,MKE
DL823,1682959659,1682960352,693,16638,Delta Air Lines,MKE,SFO
DL823,1682980672,1682984338,3666,19673,Delta Air Lines,SFO,ORD
DL823,1683007743,1683009059,1316,15258,Delta Air Lines,ORD,MKE
DL823,1683030178,1683039664,9486,11050,Delta Air Lines,MKE,ORD
DL823,1683060015,1683060741,726,6920,Delta Air Lines,ORD,MKE
DL823,1683071424,1683081094,9670,7924,Delta Air Lines,MKE,ORD
DL823,1683089371,1683091167,1796,6958,Delta Air Lines,ORD,MKE
DL823,1683108449,1683113832,5383,6992,Delta Air Lines,MKE,ORD
DL823,1683122225,1683123837,1612,19394,Delta Air Lines,ORD,MKE
DL823,1683146357,1683148118,1761,16244,Delta Air Lines,MKE,LAX
DL823,1683169581,1683170382,801,12696,Delta Air Lines,LAX,SFO
DL823,1683187494,1683195339,7845,14430,Delta Air Lines,SFO,ORD
DL823,1683211579,1683212460,881,13925,Delta Air Lines,ORD,MKE
DL823,1683235940,1683240743,4803,21547,Delta Air Lines,MKE,ORD
DL823,1683267739,1683268511,772,17342,Delta Air Lines,ORD,MKE
DL823,1683290329,1683292902,2573,7749,Delta Air Lines,MKE,ORD
DL823,1683303888,1683304293,405,17277,Delta Air Lines,ORD,MKE
DL823,1683321837,1683322028,191,11505,Delta Air Lines,MKE,SFO
DL823,1683343902,1683345586,1684,17263,Delta Air Lines,SFO,LAX
DL823,1683371801,1683372702,901,20289,Delta Air Lines,LAX,SFO
DL823,1683393397,1683394159,762,13320,Delta Air Lines,SFO,LAX
DL823,1683411491,1683421806,10315,11005,Delta Air Lines,LAX,ORD
DL823,1683442015,1683442283,268,6239,Delta Air Lines,ORD,MKE
DL823,1683458070,1683459304,1234,17535,Delta Air Lines,MKE,SFO
DL823,1683480715,1683482304,1589,6712,Delta Air Lines,SFO,LAX
DL823,1683498299,1683499390,1091,19369,Delta Air Lines,LAX,SFO
DL823,1683525237,1683531617,6380,4715,Delta Air Lines,SFO,ORD
DL823,1683539778,1683540704,926,20133,Delta Air Lines,ORD,MKE
DL823,1683567174,1683568023,849,12002,Delta Air Lines,MKE,LAX
DL823,1683580409,1683580993,584,16931,Delta Air Lines,LAX,SFO
DL823,1683599683,1683606835,7152,4418,Delta Air Lines,SFO,ORD
DL823,1683614253,1683614417,164,14683,Delta Air Lines,ORD,MKE
DL823,1683633410,1683634103,693,4837,Delta Air Lines,MKE,SFO
DL823,1683643196,1683648034,4838,6330,Delta Air Lines,SFO,ORD
DL823,1683657772,1683657851,79,6495,Delta Air Lines,ORD,MKE
DL823,1683673658,1683675190,1532,5494,Delta Air Lines,MKE,LAX
DL823,1683688140,1683692342,4202,13212,Delta Air Lines,LAX,ORD
DL823,1683713290,1683714778,1488,14534,Delta Air Lines,ORD,MKE
DL823,1683739195,1683741590,2395,5505,Delta Air Lines,MKE,ORD
DL823,1683748198,1683749861,1663,5523,Delta Air Lines,ORD,MKE
DL823,1683755996,1683757032,1036,21010,Delta Air Lines,MKE,SFO
DL823,1683784959,1683789026,4067,13426,Delta Air Lines,SFO,ORD
DL823,1683810280,1683810337,57,20185,Delta Air Lines,ORD,MKE
DL823,1683840208,1683840235,27,15747,Delta Air Lines,MKE,SFO
DL823,1683858293,1683859122,829,16070,Delta Air Lines,SFO,LAX
DL823,1683881488,1683882569,1081,14643,Delta Air Lines,LAX,SFO
DL823,1683899045,1683900277,1232,5541,Delta Air Lines,SFO,LAX
DL823,1683915279,1683915447,168,9612,Delta Air Lines,LAX,SFO
DL823,1683927633,1683932253,4620,16701,Delta Air Lines,SFO,ORD
DL823,1683951703,1683952627,924,5612,Delta Air Lines,ORD,MKE
DL823,1683964482,1683965464,982,8854,Delta Air Lines,MKE,LAX
DL823,1683978676,1683980046,1370,4991,Delta Air Lines,LAX,SFO
DL823,1683988785,1683989189,404,10584,Delta Air Lines,SFO,LAX
DL823,1683999817,1684000219,402,4602,Delta Air Lines,LAX,SFO
DL823,1684007741,1684013331,5590,9201,Delta Air Lines,SFO,ORD
DL823,1684027699,1684028271,572,20943,Delta Air Lines,ORD,MKE
DL823,1684050838,1684053757,2919,14858,Delta Air Lines,MKE,ORD
DL823,1684078736,1684079037,301,17622,Delta Air Lines,ORD,MKE
DL823,1684104925,1684105562,637,14231,Delta Air Lines,MKE,LAX
DL823,1684127537,1684128322,785,5114,Delta Air Lines,LAX,SFO
DL823,1684135399,1684144048,8649,20886,Delta Air Lines,SFO,ORD
DL823,1684175682,1684175764,82,11049,Delta Air Lines,ORD,MKE
DL823,1684193742,1684195481,1739,17339,Delta Air Lines,MKE,SFO
DL823,1684216872,1684218554,1682,20939,Delta Air Lines,SFO,LAX
DL823,1684247663,1684249356,1693,4520,Delta Air Lines,LAX,SFO
DL823,1684263431,1684265077,1646,13322,Delta Air Lines,SFO,LAX
DL823,1684281886,1684291495,9609,18167,Delta Air Lines,LAX,ORD
DL823,1684310655,1684310727,72,19526,Delta Air Lines,ORD,MKE
DL823,1684339929,1684346756,6827,17768,Delta Air Lines,MKE,ORD
DL823,1684370097,1684370674,577,17851,Delta Air Lines,ORD,MKE
DL823,1684391157,1684397345,6188,4348,Delta Air Lines,MKE,ORD
DL823,1684411120,1684412379,1259,20523,Delta Air Lines,ORD,MKE
DL823,1684437900,1684438569,669,7047,Delta Air Lines,MKE,SFO
DL823,1684450548,1684458648,8100,4390,Delta Air Lines,SFO,ORD
DL823,1684473534,1684474774,1240,9927,Delta Air Lines,ORD,MKE
DL823,1684486439,1684495189,8750,17830,Delta Air Lines,MKE,ORD
DL823,1684515554,1684515660,106,6839,Delta Air Lines,ORD,MKE
DL823,1684529279,1684530275,996,6785,Delta Air Lines,MKE,LAX
DL823,1684539756,1684544558,4802,21142,Delta Air Lines,LAX,ORD
DL823,1684567980,1684569328,1348,11293,Delta Air Lines,ORD,MKE
DL823,1684588746,1684597022,8276,15070,Delta Air Lines,MKE,ORD
DL823,1684615933,1684617516,1583,18502,Delta Air Lines,ORD,MKE
DL823,1684645527,1684645798,271,12142,Delta Air Lines,MKE,SFO
DL823,1684668298,1684676346,8048,3756,Delta Air Lines,SFO,ORD
DL823,1684689658,1684690823,1165,10995,Delta Air Lines,ORD,MKE
DL823,1684702704,1684704014,1310,20591,Delta Air Lines,MKE,LAX
DL823,1684733897,1684743098,9201,19398,Delta Air Lines,LAX,ORD
DL823,1684765435,1684766245,810,19510,Delta Air Lines,ORD,MKE
DL823,1684789608,1684789721,113,7295,Delta Air Lines,MKE,LAX
DL823,1684800965,1684809528,8563,20642,Delta Air Lines,LAX,ORD
DL823,1684839382,1684841012,1630,12936,Delta Air Lines,ORD,MKE
DL823,1684860541,1684861666,1125,5128,Delta Air Lines,MKE,SFO
DL823,1684873261,1684873321,60,8944,Delta Air Lines,SFO,LAX
DL823,1684891797,1684893007,1210,17634,Delta Air Lines,LAX,SFO
DL823,1684912688,1684920698,8010,15864,Delta Air Lines,SFO,ORD
DL823,1684939945,1684940903,958,5002,Delta Air Lines,ORD,MKE
DL823,1684946720,1684948389,1669,17254,Delta Air Lines,MKE,LAX
DL823,1684975061,1684976691,1630,4505,Delta Air Lines,LAX,SFO
DL823,1684984163,1684984889,726,3783,Delta Air Lines,SFO,LAX
DL823,1684995049,1685003046,7997,20032,Delta Air Lines,LAX,ORD
DL823,1685032786,1685034008,1222,7353,Delta Air Lines,ORD,MKE
DL823,1685046953,1685048576,1623,19090,Delta Air Lines,MKE,SFO
DL823,1685075071,1685082241,7170,17562,Delta Air Lines,SFO,ORD
DL823,1685106385,1685108094,1709,21176,Delta Air Lines,ORD,MKE
DL823,1685132876,1685133396,520,11361,Delta Air Lines,MKE,SFO
DL823,1685154595,1685161702,7107,5761,Delta Air Lines,SFO,ORD
DL823,1685167860,1685169438,1578,18784,Delta Air Lines,ORD,MKE
DL823,1685192932,1685194239,1307,11069,Delta Air Lines,MKE,SFO
DL823,1685206557,1685212355,5798,17933,Delta Air Lines,SFO,ORD
DL823,1685239968,1685240013,45,9822,Delta Air Lines,ORD,MKE
DL823,1685257462,1685257752,290,15423,Delta Air Lines,MKE,SFO
DL823,1685276785,1685284455,7670,19727,Delta Air Lines,SFO,ORD
DL823,1685305742,1685306702,960,5852,Delta Air Lines,ORD,MKE
DL823,1685316719,1685322117,5398,5301,Delta Air Lines,MKE,ORD
DL823,1685335840,1685336753,913,11883,Delta Air Lines,ORD,MKE
DL823,1685351646,1685355191,3545,18319,Delta Air Lines,MKE,ORD
DL823,1685378277,1685379031,754,7402,Delta Air Lines,ORD,MKE
DL823,1685393714,1685403885,10171,7233,Delta Air Lines,MKE,ORD
DL823,1685417007,1685418530,1523,12927,Delta Air Lines,ORD,MKE
DL823,1685431940,1685442486,10546,16998,Delta Air Lines,MKE,ORD
DL823,1685469414,1685469865,451,7348,Delta Air Lines,ORD,MKE
DL823,1685483012,1685486859,3847,19790,Delta Air Lines,MKE,ORD
DL823,1685510455,1685510550,95,16603,Delta Air Lines,ORD,MKE
DL823,1685531412,1685538865,7453,16786,Delta Air Lines,MKE,ORD
DL823,1685560633,1685560841,208,5077,Delta Air Lines,ORD,MKE
DL823,1685572084,1685573477,1393,18109,Delta Air Lines,MKE,LAX
DL823,1685598271,1685598295,24,21119,Delta Air Lines,LAX,SFO
DL823,1685630059,1685630170,111,11865,Delta Air Lines,SFO,LAX
DL823,1685648123,1685649419,1296,4114,Delta Air Lines,LAX,SFO
DL823,1685662937,1685663541,604,19530,Delta Air Lines,SFO,LAX
DL823,1685691943,1685696936,4993,6782,Delta Air Lines,LAX,ORD
DL823,1685713284,1685714268,984,15643,Delta Air Lines,ORD,MKE
DL823,1685735226,1685736289,1063,20969,Delta Air Lines,MKE,SFO
DL823,1685765619,1685771003,5384,10065,Delta Air Lines,SFO,ORD
DL823,1685789076,1685789555,479,3841,Delta Air Lines,ORD,MKE
DL823,1685797728,1685798616,888,10250,Delta Air Lines,MKE,SFO
DL823,1685816928,1685822979,6051,9641,Delta Air Lines,SFO,ORD
DL823,1685838640,1685838782,142,21436,Delta Air Lines,ORD,MKE
DL823,1685867876,1685872302,4426,3903,Delta Air Lines,MKE,ORD
DL823,1685880006,1685881582,1576,13702,Delta Air Lines,ORD,MKE
DL823,1685902600,1685903881,1281,15658,Delta Air Lines,MKE,LAX
DL823,1685927965,1685929650,1685,17046,Delta Air Lines,LAX,SFO
DL823,1685953603,1685954767,1164,14511,Delta Air Lines,SFO,LAX
DL823,1685975828,1685984566,8738,10044,Delta Air Lines,LAX,ORD
DL823,1685994944,1685996094,1150,10285,Delta Air Lines,ORD,MKE
DL823,1686016792,1686019981,3189,18958,Delta Air Lines,MKE,ORD
DL823,1686039699,1686040301,602,15020,Delta Air Lines,ORD,MKE
DL823,1686056428,1686058188,1760,15771,Delta Air Lines,MKE,SFO
DL823,1686076681,1686084951,8270,17007,Delta Air Lines,SFO,ORD
DL823,1686110798,1686112387,1589,13320,Delta Air Lines,ORD,MKE
DL823,1686127929,1686128429,500,13832,Delta Air Lines,MKE,LAX
DL823,1686148833,1686149683,850,13699,Delta Air Lines,LAX,SFO
DL823,1686166246,1686167335,1089,18807,Delta Air Lines,SFO,LAX
DL823,1686194910,1686199146,4236,16576,Delta Air Lines,LAX,ORD
DL823,1686223902,1686224406,504,13792,Delta Air Lines,ORD,MKE
DL823,1686243503,1686250446,6943,15667,Delta Air Lines,MKE,ORD
DL823,1686266210,1686266842,632,7924,Delta Air Lines,ORD,MKE
DL823,1686279460,1686279878,418,4940,Delta Air Lines,MKE,LAX
DL823,1686292451,1686298468,6017,18611,Delta Air Lines,LAX,ORD
DL823,1686326703,1686327768,1065,10320,Delta Air Lines,ORD,MKE
DL823,1686346060,1686347800,1740,7526,Delta Air Lines,MKE,LAX
DL823,1686365443,1686375594,10151,7066,Delta Air Lines,LAX,ORD
DL823,1686387406,1686388135,729,18426,Delta Air Lines,ORD,MKE
DL823,1686414254,1686415022,768,18444,Delta Air Lines,MKE,LAX
DL823,1686434911,1686434919,8,8557,Delta Air Lines,LAX,SFO
DL823,1686447712,1686447981,269,19106,Delta Air Lines,SFO,LAX
DL823,1686472256,1686473865,1609,5662,Delta Air Lines,LAX,SFO
DL823,1686481414,1686482108,694,14609,Delta Air Lines,SFO,LAX
DL823,1686499127,1686499705,578,6434,Delta Air Lines,LAX,SFO
DL823,1686510587,1686510959,372,12822,Delta Air Lines,SFO,LAX
DL823,1686525754,1686525928,174,10731,Delta Air Lines,LAX,SFO
DL823,1686537490,1686537937,447,7992,Delta Air Lines,SFO,LAX
DL823,1686547423,1686548377,954,14420,Delta Air Lines,LAX,SFO
DL823,1686572649,1686573968,1319,3767,Delta Air Lines,SFO,LAX
DL823,1686580591,1686581642,1051,4036,Delta Air Lines,LAX,SFO
DL823,1686587055,1686587145,90,20082,Delta Air Lines,SFO,LAX
DL823,1686608487,1686608557,70,16591,Delta Air Lines,LAX,SFO
DL823,1686633377,1686638068,4691,4022,Delta Air Lines,SFO,ORD
DL823,1686648673,1686649526,853,9469,Delta Air Lines,ORD,MKE
DL823,1686664316,1686671434,7118,8049,Delta Air Lines,MKE,ORD
DL823,1686684296,1686685241,945,8226,Delta Air Lines,ORD,MKE
DL823,1686697999,1686699614,1615,12545,Delta Air Lines,MKE,SFO
DL823,1686713955,1686721536,7581,9198,Delta Air Lines,SFO,ORD
DL823,1686738647,1686740002,1355,16966,Delta Air Lines,ORD,MKE
DL823,1686757996,1686759343,1347,5798,Delta Air Lines,MKE,SFO
DL823,1686767421,1686768659,1238,5994,Delta Air Lines,SFO,LAX
DL823,1686785292,1686786548,1256,7782,Delta Air Lines,LAX,SFO
DL823,1686797261,1686807479,10218,9974,Delta Air Lines,SFO,ORD
DL823,1686820519,1686822040,1521,20030,Delta Air Lines,ORD,MKE
DL823,1686849652,1686851161,1509,13746,Delta Air Lines,MKE,SFO
DL823,1686868310,1686869942,1632,12612,Delta Air Lines,SFO,LAX
DL823,1686887593,1686894337,6744,7237,Delta Air Lines,LAX,ORD
DL823,1686907915,1686908990,1075,4497,Delta Air Lines,ORD,MKE
DL823,1686919255,1686920895,1640,5780,Delta Air Lines,MKE,LAX
DL823,1686926701,1686927236,535,8048,Delta Air Lines,LAX,SFO
DL823,1686938872,1686943391,4519,12394,Delta Air Lines,SFO,ORD
DL823,1686963498,1686963521,23,6524,Delta Air Lines,ORD,MKE
DL823,1686971448,1686977066,5618,14924,Delta Air Lines,MKE,ORD
DL823,1686998389,1686999010,621,20181,Delta Air Lines,ORD,MKE
DL823,1687023935,1687025405,1470,5145,Delta Air Lines,MKE,SFO
DL823,1687040308,1687041756,1448,13661,Delta Air Lines,SFO,LAX
DL823,1687056046,1687057256,1210,15558,Delta Air Lines,LAX,SFO
DL823,1687082402,1687090050,7648,10496,Delta Air Lines,SFO,ORD
DL823,1687100847,1687101841,994,11733,Delta Air Lines,ORD,MKE
DL823,1687121030,1687122372,1342,9945,Delta Air Lines,MKE,LAX
DL823,1687132924,1687136413,3489,18340,Delta Air Lines,LAX,ORD
DL823,1687158208,1687159414,1206,19613,Delta Air Lines,ORD,MKE
DL823,1687186320,1687193788,7468,12571,Delta Air Lines,MKE,ORD
DL823,1687208008,1687208997,989,13162,Delta Air Lines,ORD,MKE
DL823,1687227041,1687227994,953,11542,Delta Air Lines,MKE,SFO
DL823,1687249047,1687259693,10646,12488,Delta Air Lines,SFO,ORD
DL823,1687276518,1687276778,260,7160,Delta Air Lines,ORD,MKE
DL823,1687285026,1687289586,4560,3929,Delta Air Lines,MKE,ORD
DL823,1687303281,1687304854,1573,5138,Delta Air Lines,ORD,MKE
DL823,1687316345,1687317308,963,13974,Delta Air Lines,MKE,SFO
DL823,1687338528,1687339562,1034,20971,Delta Air Lines,SFO,LAX
DL823,1687367480,1687371304,3824,4845,Delta Air Lines,LAX,ORD
DL823,1687382140,1687382166,26,5423,Delta Air Lines,ORD,MKE
DL823,1687394617,1687395724,1107,13281,Delta Air Lines,MKE,LAX
DL823,1687409426,1687410136,710,17192,Delta Air Lines,LAX,SFO
DL823,1687437090,1687443959,6869,11999,Delta Air Lines,SFO,ORD
DL823,1687459574,1687460640,1066,17118,Delta Air Lines,ORD,MKE
DL823,1687480733,1687481982,1249,14472,Delta Air Lines,MKE,SFO
DL823,1687502607,1687505081,2474,21090,Delta Air Lines,SFO,ORD
DL823,1687536471,1687537489,1018,15232,Delta Air Lines,ORD,MKE
DL823,1687556559,1687561778,5219,10062,Delta Air Lines,MKE,ORD
DL823,1687575805,1687576241,436,20194,Delta Air Lines,ORD,MKE
DL823,1687601444,1687602137,693,3945,Delta Air Lines,MKE,SFO
DL823,1687608414,1687613109,4695,5817,Delta Air Lines,SFO,ORD
DL823,1687626249,1687626557,308,5057,Delta Air Lines,ORD,MKE
DL823,1687634578,1687635293,715,6431,Delta Air Lines,MKE,SFO
DL823,1687649941,1687650279,338,3920,Delta Air Lines,SFO,LAX
DL823,1687656420,1687657215,795,8010,Delta Air Lines,LAX,SFO
DL823,1687669844,1687680574,10730,13598,Delta Air Lines,SFO,ORD
DL823,1687695098,1687695230,132,5458,Delta Air Lines,ORD,MKE
DL823,1687703429,1687709643,6214,9881,Delta Air Lines,MKE,ORD
DL823,1687723397,1687724267,870,20830,Delta Air Lines,ORD,MKE
DL823,1687747590,1687747769,179,17365,Delta Air Lines,MKE,LAX
DL823,1687773340,1687776569,3229,14010,Delta Air Lines,LAX,ORD
DL823,1687794296,1687794439,143,3665,Delta Air Lines,ORD,MKE
DL823,1687799494,1687803488,3994,19716,Delta Air Lines,MKE,ORD
DL823,1687825191,1687826771,1580,3831,Delta Air Lines,ORD,MKE
DL823,1687834686,1687834852,166,9613,Delta Air Lines,MKE,LAX
DL823,1687847433,1687857244,9811,10960,Delta Air Lines,LAX,ORD
DL823,1687877565,1687879026,1461,7833,Delta Air Lines,ORD,MKE
DL823,1687893651,1687895422,1771,9004,Delta Air Lines,MKE,LAX
DL823,1687914819,1687921470,6651,10150,Delta Air Lines,LAX,ORD
DL823,1687938182,1687938492,310,13672,Delta Air Lines,ORD,MKE
DL823,1687957860,1687958958,1098,7971,Delta Air Lines,MKE,LAX
DL823,1687966936,1687974072,7136,12861,Delta Air Lines,LAX,ORD
DL823,1687994748,1687995224,476,9538,Delta Air Lines,ORD,MKE
DL823,1688006544,1688008176,1632,7904,Delta Air Lines,MKE,SFO
DL823,1688022286,1688024221,1935,18579,Delta Air Lines,SFO,ORD
DL823,1688050069,1688050607,538,8742,Delta Air Lines,ORD,MKE
DL823,1688062796,1688063718,922,19829,Delta Air Lines,MKE,SFO
DL823,1688092669,1688092903,234,4490,Delta Air Lines,SFO,LAX
DL823,1688104039,1688111684,7645,19094,Delta Air Lines,LAX,ORD
DL823,1688137898,1688139385,1487,13902,Delta Air Lines,ORD,MKE
DL823,1688160403,1688167857,7454,11534,Delta Air Lines,MKE,ORD
DL823,1688189756,1688190879,1123,11484,Delta Air Lines,ORD,MKE
DL823,1688211861,1688213261,1400,15324,Delta Air Lines,MKE,LAX
DL823,1688229700,1688240357,10657,16199,Delta Air Lines,LAX,ORD
DL823,1688261764,1688262440,676,9875,Delta Air Lines,ORD,MKE
DL823,1688282277,1688289481,7204,12850,Delta Air Lines,MKE,ORD
DL823,1688310718,1688311631,913,3960,Delta Air Lines,ORD,MKE
DL823,1688322693,1688323954,1261,11354,Delta Air Lines,MKE,LAX
DL823,1688340746,1688349601,8855,7988,Delta Air Lines,LAX,ORD
DL823,1688358781,1688358852,71,16877,Delta Air Lines,ORD,MKE
DL823,1688379674,1688384231,4557,20165,Delta Air Lines,MKE,ORD
DL823,1688407303,1688408936,1633,13137,Delta Air Lines,ORD,MKE
DL823,1688432348,1688436949,4601,10143,Delta Air Lines,MKE,ORD
DL823,1688447373,1688448149,776,21009,Delta Air Lines,ORD,MKE
DL823,1688471456,1688475543,4087,7479,Delta Air Lines,MKE,ORD
DL823,1688491856,1688493304,1448,4371,Delta Air Lines,ORD,MKE
DL823,1688500580,1688501056,476,16541,Delta Air Lines,MKE,SFO
DL823,1688518866,1688519598,732,12063,Delta Air Lines,SFO,LAX
DL823,1688538456,1688538485,29,7962,Delta Air Lines,LAX,SFO
DL823,1688554351,1688556091,1740,12189,Delta Air Lines,SFO,LAX
DL823,1688573404,1688581052,7648,20652,Delta Air Lines,LAX,ORD
DL823,1688611967,1688613400,1433,7505,Delta Air Lines,ORD,MKE
DL823,1688625451,1688628544,3093,15287,Delta Air Lines,MKE,ORD
DL823,1688644109,1688644467,358,5659,Delta Air Lines,ORD,MKE
DL823,1688657147,1688666478,9331,19992,Delta Air Lines,MKE,ORD
DL823,1688691565,1688692786,1221,11613,Delta Air Lines,ORD,MKE
DL823,1688707458,1688708227,769,7463,Delta Air Lines,MKE,SFO
DL823,1688723761,1688727709,3948,15146,Delta Air Lines,SFO,ORD
DL823,1688750821,1688751881,1060,20923,Delta Air Lines,ORD,MKE
DL823,1688782134,1688782851,717,14159,Delta Air Lines,MKE,LAX
DL823,1688806588,1688806663,75,15565,Delta Air Lines,LAX,SFO
DL823,1688822499,1688823129,630,20181,Delta Air Lines,SFO,LAX
DL823,1688853349,1688853541,192,11243,Delta Air Lines,LAX,SFO
DL823,1688875247,1688876384,1137,19663,Delta Air Lines,SFO,LAX
DL823,1688902551,1688903729,1178,19824,Delta Air Lines,LAX,SFO
DL823,1688926826,1688936192,9366,13258,Delta Air Lines,SFO,ORD
DL823,1688955255,1688955555,300,17193,Delta Air Lines,ORD,MKE
DL823,1688978396,1688978831,435,18946,Delta Air Lines,MKE,SFO
DL823,1689006180,1689007034,854,15879,Delta Air Lines,SFO,LAX
DL823,1689027385,1689027476,91,9391,Delta Air Lines,LAX,SFO
DL823,1689038875,1689047407,8532,6718,Delta Air Lines,SFO,ORD
DL823,1689060045,1689060487,442,13480,Delta Air Lines,ORD,MKE
DL823,1689077650,1689078339,689,7166,Delta Air Lines,MKE,LAX
DL823,1689092541,1689093285,744,17010,Delta Air Lines,LAX,SFO
DL823,1689115561,1689118517,2956,19218,Delta Air Lines,SFO,ORD
DL823,1689138815,1689139333,518,10260,Delta Air Lines,ORD,MKE
DL823,1689151273,1689152492,1219,3995,Delta Air Lines,MKE,LAX
DL823,1689165423,1689166111,688,18128,Delta Air Lines,LAX,SFO
DL823,1689185038,1689186098,1060,11781,Delta Air Lines,SFO,LAX
DL823,1689203510,1689207462,3952,10381,Delta Air Lines,LAX,ORD
DL823,1689220151,1689221480,1329,6995,Delta Air Lines,ORD,MKE
DL823,1689229780,1689231544,1764,12047,Delta Air Lines,MKE,SFO
DL823,1689248679,1689249489,810,5989,Delta Air Lines,SFO,LAX
DL823,1689259225,1689259312,87,20880,Delta Air Lines,LAX,SFO
DL823,1689283453,1689287050,3597,6024,Delta Air Lines,SFO,ORD
DL823,1689301883,1689302050,167,19897,Delta Air Lines,ORD,MKE
DL823,1689325695,1689328575,2880,3627,Delta Air Lines,MKE,ORD
DL823,1689339771,1689341429,1658,10078,Delta Air Lines,ORD,MKE
DL823,1689359610,1689360327,717,21212,Delta Air Lines,MKE,SFO
DL823,1689383459,1689389248,5789,4665,Delta Air Lines,SFO,ORD
DL823,1689400587,1689401373,786,7809,Delta Air Lines,ORD,MKE
DL823,1689417788,1689418716,928,9055,Delta Air Lines,MKE,SFO
DL823,1689428563,1689435098,6535,16033,Delta Air Lines,SFO,ORD
DL823,1689453687,1689454159,472,15202,Delta Air Lines,ORD,MKE
DL823,1689472086,1689479432,7346,3828,Delta Air Lines,MKE,ORD
DL823,1689486650,1689487986,1336,20864,Delta Air Lines,ORD,MKE
DL823,1689517196,1689517704,508,17958,Delta Air Lines,MKE,SFO
DL823,1689543665,1689552297,8632,8927,Delta Air Lines,SFO,ORD
DL823,1689566134,1689566358,224,12220,Delta Air Lines,ORD,MKE
DL823,1689584930,1689586239,1309,11076,Delta Air Lines,MKE,LAX
DL823,1689600386,1689605557,5171,7657,Delta Air Lines,LAX,ORD
DL823,1689619459,1689620808,1349,19425,Delta Air Lines,ORD,MKE
DL823,1689641344,1689642309,965,11340,Delta Air Lines,MKE,LAX
DL823,1689663930,1689664892,962,9366,Delta Air Lines,LAX,SFO
DL823,1689683106,1689683634,528,10675,Delta Air Lines,SFO,LAX
DL823,1689695780,1689696873,1093,11538,Delta Air Lines,LAX,SFO
DL823,1689712571,1689716154,3583,19470,Delta Air Lines,SFO,ORD
DL823,1689737613,1689738228,615,6586,Delta Air Lines,ORD,MKE
DL823,1689748211,1689751190,2979,7534,Delta Air Lines,MKE,ORD
DL823,1689769272,1689769517,245,20858,Delta Air Lines,ORD,MKE
DL823,1689793083,1689801338,8255,20291,Delta Air Lines,MKE,ORD
DL823,1689829574,1689829849,275,19277,Delta Air Lines,ORD,MKE
DL823,1689853859,1689859662,5803,10135,Delta Air Lines,MKE,ORD
DL823,1689874555,1689875126,571,21410,Delta Air Lines,ORD,MKE
DL823,1689906040,1689914136,8096,4268,Delta Air Lines,MKE,ORD
DL823,1689927520,1689928343,823,19494,Delta Air Lines,ORD,MKE
DL823,1689950019,1689951396,1377,5465,Delta Air Lines,MKE,SFO
DL823,1689961734,1689963430,1696,18951,Delta Air Lines,SFO,LAX
DL823,1689984290,1689985273,983,5490,Delta Air Lines,LAX,SFO
DL823,1689997693,1690005476,7783,8869,Delta Air Lines,SFO,ORD
DL823,1690014531,1690014680,149,4008,Delta Air Lines,ORD,MKE
DL823,1690021799,1690023515,1716,4048,Delta Air Lines,MKE,SFO
DL823,1690032268,1690041438,9170,7731,Delta Air Lines,SFO,ORD
DL823,1690051964,1690053262,1298,14516,Delta Air Lines,ORD,MKE
DL823,1690071562,1690071934,372,16582,Delta Air Lines,MKE,LAX
DL823,1690092487,1690093424,937,10475,Delta Air Lines,LAX,SFO
DL823,1690104099,1690108236,4137,12690,Delta Air Lines,SFO,ORD
DL823,1690123948,1690125445,1497,21572,Delta Air Lines,ORD,MKE
DL823,1690148104,1690155385,7281,7574,Delta Air Lines,MKE,ORD
DL823,1690168030,1690169561,1531,13580,Delta Air Lines,ORD,MKE
DL823,1690187755,1690191265,3510,19210,Delta Air Lines,MKE,ORD
DL823,1690216975,1690217356,381,6206,Delta Air Lines,ORD,MKE
DL823,1690230005,1690230363,358,8785,Delta Air Lines,MKE,SFO
DL823,1690249139,1690253529,4390,21189,Delta Air Lines,SFO,ORD
DL823,1690277215,1690278158,943,15127,Delta Air Lines,ORD,MKE
DL823,1690294050,1690294268,218,11098,Delta Air Lines,MKE,SFO
DL823,1690313373,1690314302,929,15529,Delta Air Lines,SFO,LAX
DL823,1690339538,1690348521,8983,16705,Delta Air Lines,LAX,ORD
DL823,1690373046,1690373231,185,11667,Delta Air Lines,ORD,MKE
DL823,1690393562,1690393602,40,4305,Delta Air Lines,MKE,LAX
DL823,1690404425,1690406004,1579,20865,Delta Air Lines,LAX,SFO
DL823,1690433982,1690439516,5534,20582,Delta Air Lines,SFO,ORD
DL823,1690463805,1690464669,864,7686,Delta Air Lines,ORD,MKE
DL823,1690479889,1690481542,1653,6515,Delta Air Lines,MKE,LAX
DL823,1690494401,1690494930,529,12258,Delta Air Lines,LAX,SFO
DL823,1690511702,1690511726,24,8438,Delta Air Lines,SFO,LAX
DL823,1690530321,1690533560,3239,18983,Delta Air Lines,LAX,ORD
DL823,1690553934,1690555117,1183,6866,Delta Air Lines,ORD,MKE
DL823,1690568036,1690568817,781,3603,Delta Air Lines,MKE,SFO
DL823,1690578011,1690586770,8759,6864,Delta Air Lines,SFO,ORD
DL823,1690597075,1690597461,386,10152,Delta Air Lines,ORD,MKE
DL823,1690616082,1690616742,660,11701,Delta Air Lines,MKE,LAX
DL823,1690630567,1690630771,204,10590,Delta Air Lines,LAX,SFO
DL823,1690649159,1690652434,3275,15173,Delta Air Lines,SFO,ORD
DL823,1690671329,1690671907,578,10369,Delta Air Lines,ORD,MKE
DL823,1690689544,1690698578,9034,9875,Delta Air Lines,MKE,ORD
DL823,1690712105,1690712108,3,6479,Delta Air Lines,ORD,MKE
DL823,1690719222,1690720193,971,18528,Delta Air Lines,MKE,SFO
DL823,1690739419,1690746377,6958,13772,Delta Air Lines,SFO,ORD
DL823,1690769991,1690770045,54,15975,Delta Air Lines,ORD,MKE
DL823,1690795014,1690795615,601,20086,Delta Air Lines,MKE,SFO
DL823,1690822878,1690832323,9445,12151,Delta Air Lines,SFO,ORD
DL823,1690849352,1690850594,1242,18738,Delta Air Lines,ORD,MKE
DL823,1690878343,1690879641,1298,9330,Delta Air Lines,MKE,SFO
DL823,1690891932,1690898844,6912,10873,Delta Air Lines,SFO,ORD
DL823,1690918522,1690919010,488,6360,Delta Air Lines,ORD,MKE
DL823,1690930630,1690932019,1389,11518,Delta Air Lines,MKE,LAX
DL823,1690948124,1690956521,8397,4518,Delta Air Lines,LAX,ORD
DL823,1690971427,1690972533,1106,5474,Delta Air Lines,ORD,MKE
DL823,1690983377,1690984433,1056,20781,Delta Air Lines,MKE,LAX
DL823,1691014069,1691018434,4365,6429,Delta Air Lines,LAX,ORD
DL823,1691035478,1691036689,1211,16252,Delta Air Lines,ORD,MKE
DL823,1691059006,1691060359,1353,16040,Delta Air Lines,MKE,SFO
DL823,1691083157,1691083874,717,11138,Delta Air Lines,SFO,LAX
DL823,1691102591,1691103928,1337,17982,Delta Air Lines,LAX,SFO
DL823,1691128919,1691129621,702,4207,Delta Air Lines,SFO,LAX
DL823,1691136225,1691141582,5357,10017,Delta Air Lines,LAX,ORD
DL823,1691154911,1691155042,131,16974,Delta Air Lines,ORD,MKE
DL823,1691176255,1691177611,1356,8703,Delta Air Lines,MKE,SFO
DL823,1691191481,1691196393,4912,12555,Delta Air Lines,SFO,ORD
DL823,1691211569,1691213030,1461,13532,Delta Air Lines,ORD,MKE
DL823,1691229825,1691231278,1453,14794,Delta Air Lines,MKE,SFO
DL823,1691252815,1691254181,1366,4128,Delta Air Lines,SFO,LAX
DL823,1691259824,1691270262,10438,18293,Delta Air Lines,LAX,ORD
DL823,1691294611,1691294850,239,5513,Delta Air Lines,ORD,MKE
DL823,1691307965,1691318397,10432,8572,Delta Air Lines,MKE,ORD
DL823,1691328300,1691329123,823,9674,Delta Air Lines,ORD,MKE
DL823,1691341210,1691342593,1383,18190,Delta Air Lines,MKE,LAX
DL823,1691368741,1691373775,5034,12365,Delta Air Lines,LAX,ORD
DL823,1691392793,1691394100,1307,20225,Delta Air Lines,ORD,MKE
DL823,1691424570,1691427956,3386,21324,Delta Air Lines,MKE,ORD
DL823,1691453767,1691453844,77,10355,Delta Air Lines,ORD,MKE
DL823,1691473904,1691474875,971,5394,Delta Air Lines,MKE,LAX
DL823,1691488798,1691489564,766,7626,Delta Air Lines,LAX,SFO
DL823,1691503909,1691512082,8173,8498,Delta Air Lines,SFO,ORD
DL823,1691528654,1691529908,1254,8263,Delta Air Lines,ORD,MKE
DL823,1691540799,1691544328,3529,8947,Delta Air Lines,MKE,ORD
DL823,1691556487,1691557647,1160,15592,Delta Air Lines,ORD,MKE
DL823,1691575400,1691582092,6692,9824,Delta Air Lines,MKE,ORD
DL823,1691596008,1691596237,229,20232,Delta Air Lines,ORD,MKE
DL823,1691622140,1691622418,278,11288,Delta Air Lines,MKE,LAX
DL823,1691639433,1691639545,112,9260,Delta Air Lines,LAX,SFO
DL823,1691651607,1691661970,10363,14571,Delta Air Lines,SFO,ORD
DL823,1691678276,1691679746,1470,20702,Delta Air Lines,ORD,MKE
DL823,1691708930,1691711120,2190,5426,Delta Air Lines,MKE,ORD
DL823,1691722205,1691723373,1168,8140,Delta Air Lines,ORD,MKE
DL823,1691738892,1691740671,1779,7289,Delta Air Lines,MKE,SFO
DL823,1691757548,1691758076,528,19530,Delta Air Lines,SFO,LAX
DL823,1691778694,1691780457,1763,17551,Delta Air Lines,LAX,SFO
DL823,1691805204,1691807078,1874,4000,Delta Air Lines,SFO,ORD
DL823,1691819218,1691819609,391,15068,Delta Air Lines,ORD,MKE
DL823,1691839304,1691840159,855,13547,Delta Air Lines,MKE,SFO
DL823,1691860581,1691860592,11,18303,Delta Air Lines,SFO,LAX
DL823,1691884637,1691884978,341,20261,Delta Air Lines,LAX,SFO
DL823,1691915026,1691921761,6735,7258,Delta Air Lines,SFO,ORD
DL823,1691938897,1691939625,728,5870,Delta Air Lines,ORD,MKE
DL823,1691949567,1691949901,334,18740,Delta Air Lines,MKE,LAX
DL823,1691978514,1691988246,9732,19438,Delta Air Lines,LAX,ORD
DL823,1692016130,1692017284,1154,6628,Delta Air Lines,ORD,MKE
DL823,1692029268,1692033993,4725,16120,Delta Air Lines,MKE,ORD
DL823,1692057060,1692058045,985,20250,Delta Air Lines,ORD,MKE
DL823,1692086520,1692086956,436,17835,Delta Air Lines,MKE,SFO
DL823,1692111219,1692111793,574,8234,Delta Air Lines,SFO,LAX
DL823,1692130805,1692131068,263,6728,Delta Air Lines,LAX,SFO
DL823,1692139691,1692144033,4342,10348,Delta Air Lines,SFO,ORD
DL823,1692158392,1692158645,253,18027,Delta Air Lines,ORD,MKE
DL823,1692178950,1692186565,7615,9468,Delta Air Lines,MKE,ORD
DL823,1692205868,1692206454,586,6677,Delta Air Lines,ORD,MKE
DL823,1692216411,1692217135,724,10706,Delta Air Lines,MKE,LAX
DL823,1692228451,1692229777,1326,7371,Delta Air Lines,LAX,SFO
DL823,1692243004,1692243929,925,6637,Delta Air Lines,SFO,LAX
DL823,1692258766,1692260285,1519,12223,Delta Air Lines,LAX,SFO
DL823,1692274092,1692275510,1418,13374,Delta Air Lines,SFO,LAX
DL823,1692293902,1692295127,1225,13965,Delta Air Lines,LAX,SFO
DL823,1692312646,1692316044,3398,12737,Delta Air Lines,SFO,ORD
DL823,1692334841,1692336632,1791,11948,Delta Air Lines,ORD,MKE
DL823,1692355308,1692356939,1631,21582,Delta Air Lines,MKE,SFO
DL823,1692381796,1692382597,801,11916,Delta Air Lines,SFO,LAX
DL823,1692403527,1692413008,9481,20801,Delta Air Lines,LAX,ORD
DL823,1692440188,1692440337,149,20452,Delta Air Lines,ORD,MKE
DL823,1692466299,1692471211,4912,10176,Delta Air Lines,MKE,ORD
DL823,1692490497,1692490818,321,4086,Delta Air Lines,ORD,MKE
DL823,1692496740,1692499536,2796,18033,Delta Air Lines,MKE,ORD
DL823,1692522488,1692522918,430,21259,Delta Air Lines,ORD,MKE
DL823,1692547923,1692556316,8393,17168,Delta Air Lines,MKE,ORD
DL823,1692577887,1692579005,1118,10630,Delta Air Lines,ORD,MKE
DL823,1692590035,1692591025,990,13701,Delta Air Lines,MKE,SFO
DL823,1692607492,1692607646,154,15329,Delta Air Lines,SFO,LAX
DL823,1692629896,1692633700,3804,15659,Delta Air Lines,LAX,ORD
DL823,1692656462,1692658032,1570,16091,Delta Air Lines,ORD,MKE
DL823,1692679390,1692680432,1042,15431,Delta Air Lines,MKE,SFO
DL823,1692699308,1692700565,1257,9097,Delta Air Lines,SFO,LAX
DL823,1692710805,1692711444,639,10174,Delta Air Lines,LAX,SFO
DL823,1692729591,1692730278,687,17322,Delta Air Lines,SFO,LAX
DL823,1692750967,1692752356,1389,10875,Delta Air Lines,LAX,SFO
DL823,1692766277,1692766477,200,14079,Delta Air Lines,SFO,LAX
DL823,1692787929,1692788564,635,3657,Delta Air Lines,LAX,SFO
DL823,1692799770,1692809201,9431,20473,Delta Air Lines,SFO,ORD
DL823,1692835271,1692836753,1482,12620,Delta Air Lines,ORD,MKE
DL823,1692854240,1692862547,8307,7404,Delta Air Lines,MKE,ORD
DL823,1692873881,1692874090,209,17790,Delta Air Lines,ORD,MKE
DL823,1692896634,1692905341,8707,20349,Delta Air Lines,MKE,ORD
DL823,1692931858,1692932416,558,7076,Delta Air Lines,ORD,MKE
DL823,1692948067,1692948351,284,17422,Delta Air Lines,MKE,SFO
DL823,1692966564,1692966928,364,14771,Delta Air Lines,SFO,LAX
DL823,1692985970,1692991980,6010,8950,Delta Air Lines,LAX,ORD
DL823,1693010054,1693011524,1470,12034,Delta Air Lines,ORD,MKE
DL823,1693027052,1693030266,3214,14112,Delta Air Lines,MKE,ORD
DL823,1693050125,1693051704,1579,15575,Delta Air Lines,ORD,MKE
DL823,1693075169,1693076711,1542,5159,Delta Air Lines,MKE,SFO
DL823,1693089346,1693093752,4406,19237,Delta Air Lines,SFO,ORD
DL823,1693119127,1693120701,1574,10591,Delta Air Lines,ORD,MKE
DL823,1693135908,1693136242,334,13350,Delta Air Lines,MKE,SFO
DL823,1693160061,1693160420,359,18198,Delta Air Lines,SFO,LAX
DL823,1693187170,1693187778,608,14739,Delta Air Lines,LAX,SFO
DL823,1693209273,1693211620,2347,12454,Delta Air Lines,SFO,ORD
DL823,1693230627,1693232069,1442,4822,Delta Air Lines,ORD,MKE
DL823,1693237831,1693237871,40,16749,Delta Air Lines,MKE,LAX
DL823,1693261411,1693262734,1323,21095,Delta Air Lines,LAX,SFO
DL823,1693289430,1693290337,907,3960,Delta Air Lines,SFO,LAX
DL823,1693304083,1693305452,1369,13206,Delta Air Lines,LAX,SFO
DL823,1693325462,1693334280,8818,16022,Delta Air Lines,SFO,ORD
DL823,1693351059,1693351160,101,9987,Delta Air Lines,ORD,MKE
DL823,1693362837,1693363333,496,18423,Delta Air Lines,MKE,SFO
DL823,1693392510,1693392528,18,21489,Delta Air Lines,SFO,LAX
DL823,1693422062,1693425925,3863,3784,Delta Air Lines,LAX,ORD
DL823,1693437936,1693438335,399,5082,Delta Air Lines,ORD,MKE
DL823,1693446254,1693454774,8520,10862,Delta Air Lines,MKE,ORD
DL823,1693473193,1693474844,1651,6550,Delta Air Lines,ORD,MKE
DL823,1693487223,1693488166,943,18813,Delta Air Lines,MKE,LAX
DL823,1693515023,1693515841,818,6482,Delta Air Lines,LAX,SFO
DL823,1693524557,1693525480,923,20066,Delta Air Lines,SFO,LAX
DL823,1693545812,1693556087,10275,16040,Delta Air Lines,LAX,ORD
DL823,1693580786,1693580919,133,3917,Delta Air Lines,ORD,MKE
DL823,1693592932,1693593537,605,21179,Delta Air Lines,MKE,LAX
DL823,1693624000,1693626113,2113,17470,Delta Air Lines,LAX,ORD
DL823,1693644233,1693645583,1350,12195,Delta Air Lines,ORD,MKE
DL823,1693668548,1693669081,533,8446,Delta Air Lines,MKE,SFO
DL823,1693685821,1693693206,7385,12980,Delta Air Lines,SFO,ORD
DL823,1693708192,1693708676,484,9177,Delta Air Lines,ORD,MKE
DL823,1693718340,1693723438,5098,8662,Delta Air Lines,MKE,ORD
DL823,1693734908,1693735555,647,6288,Delta Air Lines,ORD,MKE
DL823,1693752245,1693759088,6843,15620,Delta Air Lines,MKE,ORD
DL823,1693778742,1693779066,324,8566,Delta Air Lines,ORD,MKE
DL823,1693791438,1693793188,1750,19012,Delta Air Lines,MKE,SFO
DL823,1693812778,1693819655,6877,16331,Delta Air Lines,SFO,ORD
DL823,1693839148,1693840487,1339,4961,Delta Air Lines,ORD,MKE
DL823,1693855190,1693856554,1364,12650,Delta Air Lines,MKE,LAX
DL823,1693872172,1693879202,7030,17553,Delta Air Lines,LAX,ORD
DL823,1693897687,1693899402,1715,18140,Delta Air Lines,ORD,MKE
DL823,1693921693,1693921926,233,9893,Delta Air Lines,MKE,SFO
DL823,1693939001,1693939037,36,13759,Delta Air Lines,SFO,LAX
DL823,1693957241,1693960949,3708,7318,Delta Air Lines,LAX,ORD
DL823,1693976721,1693976965,244,4179,Delta Air Lines,ORD,MKE
DL823,1693982565,1693983833,1268,21575,Delta Air Lines,MKE,SFO
DL823,1694016116,1694017192,1076,7362,Delta Air Lines,SFO,LAX
DL823,1694031674,1694032591,917,16815,Delta Air Lines,LAX,SFO
DL823,1694053626,1694054543,917,20848,Delta Air Lines,SFO,LAX
DL823,1694082269,1694082735,466,20232,Delta Air Lines,LAX,SFO
DL823,1694109458,1694113542,4084,12754,Delta Air Lines,SFO,ORD
DL823,1694134666,1694134800,134,16989,Delta Air Lines,ORD,MKE
DL823,1694152100,1694160364,8264,14158,Delta Air Lines,MKE,ORD
DL823,1694184511,1694185227,716,19565,Delta Air Lines,ORD,MKE
DL823,1694205932,1694209835,3903,3800,Delta Air Lines,MKE,ORD
DL823,1694217766,1694218725,959,17103,Delta Air Lines,ORD,MKE
DL823,1694238275,1694238678,403,4048,Delta Air Lines,MKE,SFO
DL823,1694244910,1694245808,898,9992,Delta Air Lines,SFO,LAX
DL823,1694265204,1694266462,1258,19459,Delta Air Lines,LAX,SFO
DL823,1694289395,1694290254,859,7668,Delta Air Lines,SFO,LAX
DL823,1694299632,1694304674,5042,18283,Delta Air Lines,LAX,ORD
DL823,1694324707,1694325811,1104,14196,Delta Air Lines,ORD,MKE
DL823,1694344875,1694345121,246,15952,Delta Air Lines,MKE,SFO
DL823,1694362654,1694363408,754,9892,Delta Air Lines,SFO,LAX
DL823,1694376050,1694380732,4682,10657,Delta Air Lines,LAX,ORD
DL823,1694399232,1694400443,1211,13617,Delta Air Lines,ORD,MKE
DL823,1694418470,1694428374,9904,6311,Delta Air Lines,MKE,ORD
DL823,1694441780,1694442294,514,15137,Delta Air Lines,ORD,MKE
DL823,1694467576,1694468018,442,19573,Delta Air Lines,MKE,LAX
DL823,1694496712,1694497815,1103,9647,Delta Air Lines,LAX,SFO
DL823,1694514950,1694515433,483,5794,Delta Air Lines,SFO,LAX
DL823,1694524614,1694525713,1099,15933,Delta Air Lines,LAX,SFO
DL823,1694545239,1694549216,3977,21489,Delta Air Lines,SFO,ORD
DL823,1694581191,1694582459,1268,16132,Delta Air Lines,ORD,MKE
DL823,1694606008,1694606579,571,15772,Delta Air Lines,MKE,SFO
DL823,1694630295,1694631137,842,18990,Delta Air Lines,SFO,LAX
DL823,1694653787,1694655152,1365,20644,Delta Air Lines,LAX,SFO
DL823,1694678220,1694679221,1001,17323,Delta Air Lines,SFO,LAX
DL823,1694702509,1694707584,5075,17730,Delta Air Lines,LAX,ORD
DL823,1694727180,1694727493,313,3689,Delta Air Lines,ORD,MKE
DL823,1694733718,1694734443,725,8319,Delta Air Lines,MKE,LAX
DL823,1694745067,1694750147,5080,16822,Delta Air Lines,LAX,ORD
DL823,1694776483,1694777690,1207,10849,Delta Air Lines,ORD,MKE
DL823,1694789677,1694791379,1702,10804,Delta Air Lines,MKE,LAX
DL823,1694803936,1694814064,10128,5123,Delta Air Lines,LAX,ORD
DL823,1694821545,1694822415,870,13245,Delta Air Lines,ORD,MKE
DL823,1694844340,1694845789,1449,14479,Delta Air Lines,MKE,SFO
DL823,1694862859,1694864517,1658,20543,Delta Air Lines,SFO,LAX
DL823,1694889167,1694889438,271,7061,Delta Air Lines,LAX,SFO
DL823,1694904416,1694905767,1351,10256,Delta Air Lines,SFO,LAX
DL823,1694917639,1694926143,8504,21288,Delta Air Lines,LAX,ORD
DL823,1694956582,1694958308,1726,14570,Delta Air Lines,ORD,MKE
DL823,1694976265,1694983020,6755,5149,Delta Air Lines,MKE,ORD
DL823,1694996221,1694997342,1121,7533,Delta Air Lines,ORD,MKE
DL823,1695012289,1695013685,1396,11008,Delta Air Lines,MKE,LAX
DL823,1695034501,1695040342,5841,19837,Delta Air Lines,LAX,ORD
DL823,1695069958,1695071512,1554,6441,Delta Air Lines,ORD,MKE
DL823,1695084161,1695091307,7146,18892,Delta Air Lines,MKE,ORD
DL823,1695110571,1695112357,1786,5666,Delta Air Lines,ORD,MKE
DL823,1695121211,1695131457,10246,21025,Delta Air Lines,MKE,ORD
DL823,1695157007,1695157081,74,13286,Delta Air Lines,ORD,MKE
DL823,1695171493,1695171586,93,20861,Delta Air Lines,MKE,LAX
DL823,1695201801,1695204421,2620,4456,Delta Air Lines,LAX,ORD
DL823,1695215416,1695215419,3,13974,Delta Air Lines,ORD,MKE
DL823,1695231987,1695240428,8441,11055,Delta Air Lines,MKE,ORD
DL823,1695259470,1695259741,271,17695,Delta Air Lines,ORD,MKE
DL823,1695283863,1695284173,310,18988,Delta Air Lines,MKE,SFO
DL823,1695307479,1695312857,5378,5620,Delta Air Lines,SFO,ORD
DL823,1695327284,1695328743,1459,6392,Delta Air Lines,ORD,MKE
DL823,1695337771,1695337959,188,5933,Delta Air Lines,MKE,SFO
DL823,1695344390,1695349235,4845,14004,Delta Air Lines,SFO,ORD
DL823,1695366006,1695367494,1488,10822,Delta Air Lines,ORD,MKE
DL823,1695381353,1695381989,636,4652,Delta Air Lines,MKE,LAX
DL823,1695387803,1695392936,5133,10589,Delta Air Lines,LAX,ORD
DL823,1695411951,1695412164,213,8497,Delta Air Lines,ORD,MKE
DL823,1695423090,1695423597,507,20085,Delta Air Lines,MKE,SFO
DL823,1695447378,1695455554,8176,8966,Delta Air Lines,SFO,ORD
DL823,1695467472,1695467697,225,21245,Delta Air Lines,ORD,MKE
DL823,1695494259,1695498209,3950,12672,Delta Air Lines,MKE,ORD
DL823,1695517011,1695517195,184,10134,Delta Air Lines,ORD,MKE
DL823,1695536753,1695543347,6594,13815,Delta Air Lines,MKE,ORD
DL823,1695560879,1695562527,1648,3975,Delta Air Lines,ORD,MKE
DL823,1695568250,1695568946,696,5688,Delta Air Lines,MKE,LAX
DL823,1695583478,1695586896,3418,14781,Delta Air Lines,LAX,ORD
DL823,1695604876,1695605252,376,14823,Delta Air Lines,ORD,MKE
DL823,1695622820,1695624252,1432,15377,Delta Air Lines,MKE,LAX
DL823,1695643460,1695643710,250,9922,Delta Air Lines,LAX,SFO
DL823,1695654997,1695655183,186,17063,Delta Air Lines,SFO,LAX
DL823,1695673363,1695674761,1398,13027,Delta Air Lines,LAX,SFO
DL823,1695692011,1695692385,374,14013,Delta Air Lines,SFO,LAX
DL823,1695711587,1695712055,468,10338,Delta Air Lines,LAX,SFO
DL823,1695725202,1695726800,1598,18508,Delta Air Lines,SFO,LAX
DL823,1695752004,1695752491,487,21104,Delta Air Lines,LAX,SFO
DL823,1695783266,1695783266,0,19800,Delta Air Lines,SFO,LAX
DL823,1695813724,1695821225,7501,5787,Delta Air Lines,LAX,ORD
DL823,1695827418,1695827556,138,5448,Delta Air Lines,ORD,MKE
DL823,1695836856,1695840672,3816,12790,Delta Air Lines,MKE,ORD
DL823,1695864135,1695865574,1439,11714,Delta Air Lines,ORD,MKE
DL823,1695886988,1695888416,1428,4456,Delta Air Lines,MKE,SFO
DL823,1695900914,1695900961,47,16137,Delta Air Lines,SFO,LAX
DL823,1695917579,1695920420,2841,18929,Delta Air Lines,LAX,ORD
DL823,1695940084,1695940515,431,12558,Delta Air Lines,ORD,MKE
DL823,1695959996,1695962222,2226,20688,Delta Air Lines,MKE,ORD
DL823,1695983793,1695984745,952,19143,Delta Air Lines,ORD,MKE
DL823,1696013687,1696020003,6316,10446,Delta Air Lines,MKE,ORD
DL823,1696032468,1696034109,1641,11312,Delta Air Lines,ORD,MKE
DL823,1696055886,1696058423,2537,8578,Delta Air Lines,MKE,ORD
DL823,1696067139,1696067290,151,15566,Delta Air Lines,ORD,MKE
DL823,1696093285,1696094300,1015,15559,Delta Air Lines,MKE,LAX
DL823,1696113886,1696113928,42,16943,Delta Air Lines,LAX,SFO
DL823,1696139380,1696150039,10659,11436,Delta Air Lines,SFO,ORD
DL823,1696164711,1696164773,62,16204,Delta Air Lines,ORD,MKE
DL823,1696191765,1696201064,9299,18822,Delta Air Lines,MKE,ORD
DL823,1696222262,1696222529,267,16450,Delta Air Lines,ORD,MKE
DL823,1696247610,1696248498,888,4136,Delta Air Lines,MKE,LAX
DL823,1696258569,1696261734,3165,8702,Delta Air Lines,LAX,ORD
DL823,1696278307,1696278497,190,11298,Delta Air Lines,ORD,MKE
DL823,1696299954,1696306742,6788,20452,Delta Air Lines,MKE,ORD
DL823,1696335593,1696337011,1418,7803,Delta Air Lines,ORD,MKE
DL823,1696346466,1696347351,885,16043,Delta Air Lines,MKE,SFO
DL823,1696370076,1696374286,4210,5781,Delta Air Lines,SFO,ORD
DL823,1696384690,1696384735,45,4649,Delta Air Lines,ORD,MKE
DL823,1696395187,1696396196,1009,13678,Delta Air Lines,MKE,SFO
DL823,1696418981,1696419881,900,17535,Delta Air Lines,SFO,LAX
DL823,1696441955,1696447515,5560,18466,Delta Air Lines,LAX,ORD
DL823,1696476087,1696476109,22,13279,Delta Air Lines,ORD,MKE
DL823,1696496471,1696498237,1766,20554,Delta Air Lines,MKE,LAX
DL823,1696523856,1696533795,9939,14334,Delta Air Lines,LAX,ORD
DL823,1696558919,1696559986,1067,4002,Delta Air Lines,ORD,MKE
DL823,1696572547,1696573732,1185,7366,Delta Air Lines,MKE,SFO
DL823,1696590169,1696590508,339,3672,Delta Air Lines,SFO,LAX
DL823,1696604853,1696604853,0,7485,Delta Air Lines,LAX,SFO
DL823,1696622056,1696622821,765,13611,Delta Air Lines,SFO,LAX
DL823,1696638188,1696639461,1273,15993,Delta Air Lines,LAX,SFO
DL823,1696664707,1696665680,973,19533,Delta Air Lines,SFO,LAX
DL823,1696686288,1696693146,6858,18366,Delta Air Lines,LAX,ORD
DL823,1696713820,1696714775,955,5281,Delta Air Lines,ORD,MKE
DL823,1696728454,1696729819,1365,18778,Delta Air Lines,MKE,SFO
DL823,1696756147,1696756494,347,11049,Delta Air Lines,SFO,LAX
DL823,1696768454,1696777858,9404,13104,Delta Air Lines,LAX,ORD
DL823,1696794267,1696794928,661,11728,Delta Air Lines,ORD,MKE
DL823,1696809090,1696809239,149,16688,Delta Air Lines,MKE,LAX
DL823,1696830821,1696831245,424,4165,Delta Air Lines,LAX,SFO
DL823,1696837934,1696838688,754,9501,Delta Air Lines,SFO,LAX
DL823,1696855316,1696855913,597,13495,Delta Air Lines,LAX,SFO
DL823,1696877599,1696877962,363,16982,Delta Air Lines,SFO,LAX
DL823,1696895067,1696900799,5732,19249,Delta Air Lines,LAX,ORD
DL823,1696925051,1696926580,1529,16044,Delta Air Lines,ORD,MKE
DL823,1696944115,1696945221,1106,17183,Delta Air Lines,MKE,LAX
DL823,1696969542,1696976777,7235,5047,Delta Air Lines,LAX,ORD
DL823,1696983210,1696983693,483,6341,Delta Air Lines,ORD,MKE
DL823,1696996479,1696997541,1062,4260,Delta Air Lines,MKE,SFO
DL823,1697009332,1697009874,542,10856,Delta Air Lines,SFO,LAX
DL823,1697024635,1697026365,1730,19227,Delta Air Lines,LAX,SFO
DL823,1697051171,1697053124,1953,12704,Delta Air Lines,SFO,ORD
DL823,1697074556,1697075003,447,5569,Delta Air Lines,ORD,MKE
DL823,1697080975,1697081405,430,6453,Delta Air Lines,MKE,LAX
DL823,1697094919,1697096664,1745,6769,Delta Air Lines,LAX,SFO
DL823,1697112376,1697121857,9481,10826,Delta Air Lines,SFO,ORD
DL823,1697141942,1697143156,1214,4894,Delta Air Lines,ORD,MKE
DL823,1697154896,1697158848,3952,14553,Delta Air Lines,MKE,ORD
DL823,1697174469,1697176076,1607,6854,Delta Air Lines,ORD,MKE
DL823,1697185276,1697191024,5748,8665,Delta Air Lines,MKE,ORD
DL823,1697202326,1697203771,1445,11082,Delta Air Lines,ORD,MKE
DL823,1697216811,1697217351,540,6743,Delta Air Lines,MKE,LAX
DL823,1697234027,1697234673,646,5772,Delta Air Lines,LAX,SFO
DL823,1697247174,1697248685,1511,12554,Delta Air Lines,SFO,LAX
DL823,1697271271,1697272030,759,19589,Delta Air Lines,LAX,SFO
DL823,1697299867,1697299999,132,10630,Delta Air Lines,SFO,LAX
DL823,1697310892,1697314501,3609,17614,Delta Air Lines,LAX,ORD
DL823,1697335233,1697336707,1474,17967,Delta Air Lines,ORD,MKE
DL823,1697361737,1697362797,1060,13577,Delta Air Lines,MKE,SFO
DL823,1697378674,1697379245,571,8575,Delta Air Lines,SFO,LAX
DL823,1697388988,1697393795,4807,3869,Delta Air Lines,LAX,ORD
DL823,1697403856,1697403867,11,20230,Delta Air Lines,ORD,MKE
DL823,1697431104,1697431825,721,19780,Delta Air Lines,MKE,LAX
DL823,1697452778,1697454007,1229,10484,Delta Air Lines,LAX,SFO
DL823,1697464666,1697472503,7837,16655,Delta Air Lines,SFO,ORD
DL823,1697495295,1697495743,448,9658,Delta Air Lines,ORD,MKE
DL823,1697512384,1697513805,1421,7740,Delta Air Lines,MKE,LAX
DL823,1697530268,1697531105,837,6100,Delta Air Lines,LAX,SFO
DL823,1697539158,1697544840,5682,6353,Delta Air Lines,SFO,ORD
DL823,1697556920,1697557399,479,7325,Delta Air Lines,ORD,MKE
DL823,1697567107,1697568201,1094,18681,Delta Air Lines,MKE,LAX
DL823,1697593363,1697596919,3556,14799,Delta Air Lines,LAX,ORD
DL823,1697618749,1697620216,1467,7423,Delta Air Lines,ORD,MKE
DL823,1697628125,1697629065,940,20638,Delta Air Lines,MKE,LAX
DL823,1697660276,1697665809,5533,5559,Delta Air Lines,LAX,ORD
DL823,1697676986,1697678490,1504,15533,Delta Air Lines,ORD,MKE
DL823,1697694504,1697694862,358,16703,Delta Air Lines,MKE,LAX
DL823,1697713842,1697723535,9693,11428,Delta Air Lines,LAX,ORD
DL823,1697744418,1697745393,975,8884,Delta Air Lines,ORD,MKE
DL823,1697758578,1697764987,6409,16758,Delta Air Lines,MKE,ORD
DL823,1697792388,1697792819,431,21470,Delta Air Lines,ORD,MKE
DL823,1697816133,1697822899,6766,16412,Delta Air Lines,MKE,ORD
DL823,1697849680,1697850422,742,9813,Delta Air Lines,ORD,MKE
DL823,1697863844,1697865521,1677,12908,Delta Air Lines,MKE,SFO
DL823,1697886201,1697894676,8475,17050,Delta Air Lines,SFO,ORD
DL823,1697921767,1697922039,272,18232,Delta Air Lines,ORD,MKE
DL823,1697944319,1697944487,168,5019,Delta Air Lines,MKE,SFO
DL823,1697958058,1697959713,1655,15374,Delta Air Lines,SFO,LAX
DL823,1697975909,1697975981,72,12579,Delta Air Lines,LAX,SFO
DL823,1697991100,1697991695,595,20617,Delta Air Lines,SFO,LAX
DL823,1698012552,1698017213,4661,3808,Delta Air Lines,LAX,ORD
DL823,1698021068,1698021512,444,21275,Delta Air Lines,ORD,MKE
DL823,1698044390,1698054131,9741,15172,Delta Air Lines,MKE,ORD
DL823,1698071702,1698073146,1444,17904,Delta Air Lines,ORD,MKE
DL823,1698095982,1698097362,1380,7712,Delta Air Lines,MKE,SFO
DL823,1698111717,1698116907,5190,20032,Delta Air Lines,SFO,ORD
DL823,1698145726,1698146503,777,16907,Delta Air Lines,ORD,MKE
DL823,1698173070,1698174311,1241,9130,Delta Air Lines,MKE,LAX
DL823,1698183772,1698191278,7506,8468,Delta Air Lines,LAX,ORD
DL823,1698209723,1698210320,597,9899,Delta Air Lines,ORD,MKE
DL823,1698230211,1698231506,1295,11778,Delta Air Lines,MKE,LAX
DL823,1698248214,1698249370,1156,21360,Delta Air Lines,LAX,SFO
DL823,1698274120,1698283041,8921,18786,Delta Air Lines,SFO,ORD
DL823,1698310992,1698311823,831,3657,Delta Air Lines,ORD,MKE
DL823,1698320310,1698326661,6351,13021,Delta Air Lines,MKE,ORD
DL823,1698346809,1698348239,1430,14003,Delta Air Lines,ORD,MKE
DL823,1698362948,1698364429,1481,21017,Delta Air Lines,MKE,SFO
DL823,1698386616,1698387085,469,14034,Delta Air Lines,SFO,LAX
DL823,1698403043,1698404645,1602,21263,Delta Air Lines,LAX,SFO
DL823,1698433356,1698440111,6755,15616,Delta Air Lines,SFO,ORD
DL823,1698460176,1698460841,665,13754,Delta Air Lines,ORD,MKE
DL823,1698479022,1698479899,877,19838,Delta Air Lines,MKE,LAX
AA192,1682959659,1682967592,7933,6298,American Airlines,SFO,ORD
AA192,1682980816,1682981370,554,17506,American Airlines,ORD,MKE
AA192,1682999002,1682999236,234,6796,American Airlines,MKE,SFO
AA192,1683012734,1683014739,2005,16724,American Airlines,SFO,ORD
AA192,1683038508,1683040280,1772,18809,American Airlines,ORD,MKE
AA192,1683066462,1683074937,8475,14825,American Airlines,MKE,ORD
AA192,1683096108,1683096824,716,9523,American Airlines,ORD,MKE
AA192,1683110204,1683111439,1235,4475,American Airlines,MKE,LAX
AA192,1683116733,1683125711,8978,17684,American Airlines,LAX,ORD
AA192,1683146462,1683146533,71,18695,American Airlines,ORD,MKE
AA192,1683171897,1683172377,480,6722,American Airlines,MKE,LAX
AA192,1683184971,1683190606,5635,16622,American Airlines,LAX,ORD
AA192,1683214367,1683214933,566,17166,American Airlines,ORD,MKE
AA192,1683237866,1683242620,4754,21409,American Airlines,MKE,ORD
AA192,1683266226,1683267539,1313,10151,American Airlines,ORD,MKE
AA192,1683280679,1683281933,1254,17751,American Airlines,MKE,SFO
AA192,1683302529,1683305493,2964,21291,American Airlines,SFO,ORD
AA192,1683327883,1683329592,1709,6760,American Airlines,ORD,MKE
AA192,1683345838,1683346385,547,8487,American Airlines,MKE,SFO
AA192,1683358409,1683359390,981,12937,American Airlines,SFO,LAX
AA192,1683378823,1683379463,640,13177,American Airlines,LAX,SFO
AA192,1683394308,1683401200,6892,20776,American Airlines,SFO,ORD
AA192,1683422749,1683422959,210,6619,American Airlines,ORD,MKE
AA192,1683430849,1683433245,2396,15365,American Airlines,MKE,ORD
AA192,1683458722,1683458788,66,10824,American Airlines,ORD,MKE
AA192,1683471012,1683472010,998,15338,American Airlines,MKE,SFO
AA192,1683497341,1683502786,5445,11468,American Airlines,SFO,ORD
AA192,1683517961,1683518930,969,10752,American Airlines,ORD,MKE
AA192,1683533757,1683535447,1690,5606,American Airlines,MKE,LAX
AA192,1683545397,1683551036,5639,10228,American Airlines,LAX,ORD
AA192,1683570188,1683571230,1042,7273,American Airlines,ORD,MKE
AA192,1683585296,1683585920,624,18888,American Airlines,MKE,LAX
AA192,1683615432,1683620730,5298,6596,American Airlines,LAX,ORD
AA192,1683634652,1683636006,1354,15281,American Airlines,ORD,MKE
AA192,1683651544,1683652457,913,9982,American Airlines,MKE,LAX
AA192,1683668036,1683668905,869,6444,American Airlines,LAX,SFO
AA192,1683681294,1683684147,2853,3785,American Airlines,SFO,ORD
AA192,1683694421,1683694668,247,4574,American Airlines,ORD,MKE
AA192,1683705201,1683708315,3114,20762,American Airlines,MKE,ORD
AA192,1683738888,1683739216,328,8056,American Airlines,ORD,MKE
AA192,1683750711,1683751339,628,10527,American Airlines,MKE,SFO
AA192,1683763729,1683764333,604,6569,American Airlines,SFO,LAX
AA192,1683779713,1683790289,10576,15243,American Airlines,LAX,ORD
AA192,1683814511,1683815107,596,17935,American Airlines,ORD,MKE
AA192,1683840874,1683842653,1779,18625,American Airlines,MKE,LAX
AA192,1683864830,1683866021,1191,5189,American Airlines,LAX,SFO
AA192,1683879182,1683879983,801,12965,American Airlines,SFO,LAX
AA192,1683903100,1683906071,2971,10028,American Airlines,LAX,ORD
AA192,1683926143,1683926201,58,18398,American Airlines,ORD,MKE
AA192,1683952232,1683953204,972,11944,American Airlines,MKE,SFO
AA192,1683967413,1683967432,19,10352,American Airlines,SFO,LAX
AA192,1683986868,1683990284,3416,11647,American Airlines,LAX,ORD
AA192,1684003426,1684005114,1688,17553,American Airlines,ORD,MKE
AA192,1684033062,1684034502,1440,4011,American Airlines,MKE,LAX
AA192,1684042951,1684046518,3567,7378,American Airlines,LAX,ORD
AA192,1684055030,1684056114,1084,13053,American Airlines,ORD,MKE
AA192,1684069843,1684075026,5183,13047,American Airlines,MKE,ORD
AA192,1684094965,1684095969,1004,18614,American Airlines,ORD,MKE
AA192,1684122807,1684123566,759,19492,American Airlines,MKE,SFO
AA192,1684146112,1684147663,1551,13293,American Airlines,SFO,LAX
AA192,1684165592,1684166038,446,21072,American Airlines,LAX,SFO
AA192,1684194927,1684195197,270,6860,American Airlines,SFO,LAX
AA192,1684207285,1684216382,9097,13925,American Airlines,LAX,ORD
AA192,1684230807,1684231434,627,5923,American Airlines,ORD,MKE
AA192,1684245365,1684246653,1288,10991,American Airlines,MKE,LAX
AA192,1684262882,1684270850,7968,10944,American Airlines,LAX,ORD
AA192,1684286692,1684287828,1136,4460,American Airlines,ORD,MKE
AA192,1684295986,1684302683,6697,12347,American Airlines,MKE,ORD
AA192,1684317145,1684318181,1036,12174,American Airlines,ORD,MKE
AA192,1684334693,1684335831,1138,8512,American Airlines,MKE,SFO
AA192,1684352115,1684352876,761,14239,American Airlines,SFO,LAX
AA192,1684371361,1684379831,8470,16236,American Airlines,LAX,ORD
AA192,1684403910,1684404566,656,12843,American Airlines,ORD,MKE
AA192,1684424181,1684425091,910,7875,American Airlines,MKE,LAX
AA192,1684433773,1684434495,722,17432,American Airlines,LAX,SFO
AA192,1684457143,1684457573,430,10911,American Airlines,SFO,LAX
AA192,1684471656,1684472291,635,16912,American Airlines,LAX,SFO
AA192,1684491274,1684497593,6319,20521,American Airlines,SFO,ORD
AA192,1684526629,1684528367,1738,8560,American Airlines,ORD,MKE
AA192,1684543824,1684543828,4,11847,American Airlines,MKE,LAX
AA192,1684559805,1684562496,2691,7595,American Airlines,LAX,ORD
AA192,1684572818,1684572948,130,13116,American Airlines,ORD,MKE
AA192,1684589310,1684590256,946,20129,American Airlines,MKE,LAX
AA192,1684613091,1684614497,1406,13582,American Airlines,LAX,SFO
AA192,1684631992,1684638103,6111,7289,American Airlines,SFO,ORD
AA192,1684645984,1684646165,181,12901,American Airlines,ORD,MKE
AA192,1684666941,1684674142,7201,6455,American Airlines,MKE,ORD
AA192,1684688723,1684689729,1006,9711,American Airlines,ORD,MKE
AA192,1684704556,1684706138,1582,8517,American Airlines,MKE,SFO
AA192,1684716398,1684717389,991,11112,American Airlines,SFO,LAX
AA192,1684732460,1684733046,586,17926,American Airlines,LAX,SFO
AA192,1684758179,1684758506,327,4536,American Airlines,SFO,LAX
AA192,1684767700,1684768884,1184,15812,American Airlines,LAX,SFO
AA192,1684785182,1684786296,1114,20685,American Airlines,SFO,LAX
AA192,1684809922,1684813131,3209,3784,American Airlines,LAX,ORD
AA192,1684826555,1684827700,1145,5354,American Airlines,ORD,MKE
AA192,1684837837,1684847945,10108,19915,American Airlines,MKE,ORD
AA192,1684876699,1684878316,1617,15456,American Airlines,ORD,MKE
AA192,1684903019,1684913554,10535,9452,American Airlines,MKE,ORD
AA192,1684924437,1684925161,724,5237,American Airlines,ORD,MKE
AA192,1684940710,1684945713,5003,14396,American Airlines,MKE,ORD
AA192,1684966222,1684967691,1469,10298,American Airlines,ORD,MKE
AA192,1684980395,1684981680,1285,5077,American Airlines,MKE,LAX
AA192,1684987073,1684996033,8960,4975,American Airlines,LAX,ORD
AA192,1685007250,1685007308,58,19630,American Airlines,ORD,MKE
AA192,1685035047,1685035296,249,10306,American Airlines,MKE,LAX
AA192,1685045905,1685056269,10364,7239,American Airlines,LAX,ORD
AA192,1685072432,1685074076,1644,4658,American Airlines,ORD,MKE
AA192,1685081780,1685088274,6494,7593,American Airlines,MKE,ORD
AA192,1685103504,1685105272,1768,9984,American Airlines,ORD,MKE
AA192,1685116313,1685116755,442,4042,American Airlines,MKE,SFO
AA192,1685125792,1685131335,5543,15934,American Airlines,SFO,ORD
AA192,1685149270,1685150769,1499,16245,American Airlines,ORD,MKE
AA192,1685173500,1685174460,960,15551,American Airlines,MKE,SFO
AA192,1685195056,1685196840,1784,20477,American Airlines,SFO,LAX
AA192,1685221522,1685221527,5,5356,American Airlines,LAX,SFO
AA192,1685234272,1685235785,1513,13466,American Airlines,SFO,LAX
AA192,1685251199,1685252110,911,19336,American Airlines,LAX,SFO
AA192,1685275847,1685278686,2839,8659,American Airlines,SFO,ORD
AA192,1685289394,1685290911,1517,4431,American Airlines,ORD,MKE
AA192,1685299446,1685300852,1406,19918,American Airlines,MKE,SFO
AA192,1685331541,1685336380,4839,17478,American Airlines,SFO,ORD
AA192,1685363135,1685364670,1535,10358,American Airlines,ORD,MKE
AA192,1685376815,1685379467,2652,15679,American Airlines,MKE,ORD
AA192,1685403657,1685404390,733,14916,American Airlines,ORD,MKE
AA192,1685427270,1685437001,9731,20179,American Airlines,MKE,ORD
AA192,1685467679,1685467851,172,10747,American Airlines,ORD,MKE
AA192,1685486796,1685488328,1532,8426,American Airlines,MKE,SFO
AA192,1685499150,1685501106,1956,12293,American Airlines,SFO,ORD
AA192,1685514839,1685516576,1737,11211,American Airlines,ORD,MKE
AA192,1685532892,1685533687,795,18773,American Airlines,MKE,SFO
AA192,1685561866,1685562982,1116,18864,American Airlines,SFO,LAX
AA192,1685581985,1685584529,2544,11338,American Airlines,LAX,ORD
AA192,1685597546,1685597797,251,14462,American Airlines,ORD,MKE
AA192,1685622226,1685623504,1278,10624,American Airlines,MKE,LAX
AA192,1685639185,1685640200,1015,20221,American Airlines,LAX,SFO
AA192,1685669828,1685671399,1571,17944,American Airlines,SFO,LAX
AA192,1685691158,1685695192,4034,16855,American Airlines,LAX,ORD
AA192,1685713164,1685713385,221,18311,American Airlines,ORD,MKE
AA192,1685735043,1685738717,3674,9344,American Airlines,MKE,ORD
AA192,1685750225,1685751968,1743,17961,American Airlines,ORD,MKE
AA192,1685771390,1685775170,3780,11596,American Airlines,MKE,ORD
AA192,1685790360,1685790632,272,4925,American Airlines,ORD,MKE
AA192,1685801164,1685802747,1583,20914,American Airlines,MKE,LAX
AA192,1685825576,1685831005,5429,18681,American Airlines,LAX,ORD
AA192,1685851429,1685852353,924,3857,American Airlines,ORD,MKE
AA192,1685857414,1685857564,150,21291,American Airlines,MKE,SFO
AA192,1685886847,1685887584,737,19106,American Airlines,SFO,LAX
AA192,1685917062,1685917882,820,12820,American Airlines,LAX,SFO
AA192,1685939940,1685941634,1694,3605,American Airlines,SFO,LAX
AA192,1685946877,1685956839,9962,16335,American Airlines,LAX,ORD
AA192,1685982233,1685982268,35,5434,American Airlines,ORD,MKE
AA192,1685997288,1686001388,4100,19549,American Airlines,MKE,ORD
AA192,1686026051,1686027312,1261,7096,American Airlines,ORD,MKE
AA192,1686036492,1686041407,4915,17805,American Airlines,MKE,ORD
AA192,1686063377,1686065064,1687,12592,American Airlines,ORD,MKE
AA192,1686078675,1686079590,915,15532,American Airlines,MKE,LAX
AA192,1686096396,1686107057,10661,4391,American Airlines,LAX,ORD
AA192,1686112873,1686112950,77,14600,American Airlines,ORD,MKE
AA192,1686129131,1686129839,708,12730,American Airlines,MKE,SFO
AA192,1686152321,1686153391,1070,9065,American Airlines,SFO,LAX
AA192,1686169847,1686176522,6675,8070,American Airlines,LAX,ORD
AA192,1686192982,1686194060,1078,14223,American Airlines,ORD,MKE
AA192,1686211587,1686217367,5780,6054,American Airlines,MKE,ORD
AA192,1686232826,1686233996,1170,4773,American Airlines,ORD,MKE
AA192,1686248128,1686249807,1679,15377,American Airlines,MKE,LAX
AA192,1686272099,1686277748,5649,11802,American Airlines,LAX,ORD
AA192,1686293321,1686293742,421,12496,American Airlines,ORD,MKE
AA192,1686314260,1686324914,10654,14940,American Airlines,MKE,ORD
AA192,1686345674,1686345720,46,6685,American Airlines,ORD,MKE
AA192,1686357966,1686363881,5915,5059,American Airlines,MKE,ORD
AA192,1686376173,1686376272,99,15010,American Airlines,ORD,MKE
AA192,1686401556,1686402796,1240,7405,American Airlines,MKE,SFO
AA192,1686419282,1686419596,314,13912,American Airlines,SFO,LAX
AA192,1686440563,1686441120,557,4091,American Airlines,LAX,SFO
AA192,1686450255,1686460646,10391,15844,American Airlines,SFO,ORD
AA192,1686485841,1686487303,1462,5589,American Airlines,ORD,MKE
AA192,1686498073,1686499572,1499,4320,American Airlines,MKE,LAX
AA192,1686507493,1686515824,8331,9710,American Airlines,LAX,ORD
AA192,1686530984,1686531738,754,4654,American Airlines,ORD,MKE
AA192,1686544815,1686545948,1133,17517,American Airlines,MKE,LAX
AA192,1686573272,1686573770,498,15215,American Airlines,LAX,SFO
AA192,1686596523,1686598009,1486,4877,American Airlines,SFO,LAX
AA192,1686608578,1686610008,1430,19178,American Airlines,LAX,SFO
AA192,1686633270,1686633763,493,19817,American Airlines,SFO,LAX
AA192,1686662800,1686662952,152,20128,American Airlines,LAX,SFO
AA192,1686684697,1686685151,454,5143,American Airlines,SFO,LAX
AA192,1686691876,1686697843,5967,16096,American Airlines,LAX,ORD
AA192,1686718425,1686720065,1640,12466,American Airlines,ORD,MKE
AA192,1686737506,1686739044,1538,15980,American Airlines,MKE,LAX
AA192,1686756837,1686757600,763,21512,American Airlines,LAX,SFO
AA192,1686781797,1686789493,7696,6550,American Airlines,SFO,ORD
AA192,1686799420,1686799855,435,8237,American Airlines,ORD,MKE
AA192,1686808456,1686815185,6729,10653,American Airlines,MKE,ORD
AA192,1686827953,1686828808,855,10312,American Airlines,ORD,MKE
AA192,1686839994,1686843176,3182,9844,American Airlines,MKE,ORD
AA192,1686861691,1686862830,1139,4001,American Airlines,ORD,MKE
AA192,1686869864,1686871269,1405,12919,American Airlines,MKE,LAX
AA192,1686886121,1686896280,10159,9147,American Airlines,LAX,ORD
AA192,1686914847,1686915607,760,17744,American Airlines,ORD,MKE
AA192,1686940896,1686946926,6030,3710,American Airlines,MKE,ORD
AA192,1686961218,1686962862,1644,19940,American Airlines,ORD,MKE
AA192,1686991816,1686992728,912,16335,American Airlines,MKE,SFO
AA192,1687017375,1687021529,4154,21336,American Airlines,SFO,ORD
AA192,1687045159,1687045658,499,18738,American Airlines,ORD,MKE
AA192,1687074476,1687076177,1701,6028,American Airlines,MKE,SFO
AA192,1687085193,1687085791,598,16632,American Airlines,SFO,LAX
AA192,1687110059,1687110258,199,19981,American Airlines,LAX,SFO
AA192,1687134229,1687135890,1661,14161,American Airlines,SFO,LAX
AA192,1687153861,1687154694,833,18705,American Airlines,LAX,SFO
AA192,1687175009,1687175333,324,6007,American Airlines,SFO,LAX
AA192,1687181696,1687186184,4488,7206,American Airlines,LAX,ORD
AA192,1687201792,1687202722,930,5155,American Airlines,ORD,MKE
AA192,1687213595,1687221540,7945,21550,American Airlines,MKE,ORD
AA192,1687245751,1687246872,1121,13550,American Airlines,ORD,MKE
AA192,1687268369,1687270155,1786,8227,American Airlines,MKE,LAX
AA192,1687288719,1687290092,1373,13389,American Airlines,LAX,SFO
AA192,1687306784,1687307653,869,8618,American Airlines,SFO,LAX
AA192,1687324783,1687325689,906,14242,American Airlines,LAX,SFO
AA192,1687350551,1687351002,451,15550,American Airlines,SFO,LAX
AA192,1687370025,1687375560,5535,5606,American Airlines,LAX,ORD
AA192,1687388738,1687388889,151,7380,American Airlines,ORD,MKE
AA192,1687396438,1687396619,181,3628,American Airlines,MKE,SFO
AA192,1687404001,1687405083,1082,5994,American Airlines,SFO,LAX
AA192,1687414937,1687418546,3609,17782,American Airlines,LAX,ORD
AA192,1687443057,1687443672,615,15651,American Airlines,ORD,MKE
AA192,1687467275,1687468970,1695,4487,American Airlines,MKE,LAX
AA192,1687477581,1687479539,1958,18968,American Airlines,LAX,ORD
AA192,1687508725,1687509145,420,20951,American Airlines,ORD,MKE
AA192,1687532834,1687533341,507,13201,American Airlines,MKE,SFO
AA192,1687554666,1687558649,3983,6705,American Airlines,SFO,ORD
AA192,1687573721,1687574641,920,8516,American Airlines,ORD,MKE
AA192,1687587189,1687593107,5918,14087,American Airlines,MKE,ORD
AA192,1687608174,1687609496,1322,14758,American Airlines,ORD,MKE
AA192,1687631558,1687641677,10119,18439,American Airlines,MKE,ORD
AA192,1687664101,1687664218,117,11809,American Airlines,ORD,MKE
AA192,1687678739,1687679881,1142,15522,American Airlines,MKE,LAX
AA192,1687697698,1687701023,3325,18166,American Airlines,LAX,ORD
AA192,1687721381,1687721439,58,19927,American Airlines,ORD,MKE
AA192,1687746426,1687747636,1210,10546,American Airlines,MKE,SFO
AA192,1687762458,1687769649,7191,11387,American Airlines,SFO,ORD
AA192,1687781726,1687783296,1570,10246,American Airlines,ORD,MKE
AA192,1687793885,1687795456,1571,19750,American Airlines,MKE,SFO
AA192,1687819663,1687820120,457,11869,American Airlines,SFO,LAX
AA192,1687838846,1687839884,1038,20560,American Airlines,LAX,SFO
AA192,1687869828,1687871231,1403,9407,American Airlines,SFO,LAX
AA192,1687881329,1687882388,1059,16562,American Airlines,LAX,SFO
AA192,1687908176,1687908464,288,7664,American Airlines,SFO,LAX
AA192,1687924577,1687927653,3076,10536,American Airlines,LAX,ORD
AA192,1687939715,1687940783,1068,7369,American Airlines,ORD,MKE
AA192,1687952172,1687952617,445,15092,American Airlines,MKE,SFO
AA192,1687977836,1687986991,9155,5476,American Airlines,SFO,ORD
AA192,1688000605,1688001502,897,19990,American Airlines,ORD,MKE
AA192,1688025132,1688025581,449,5430,American Airlines,MKE,LAX
AA192,1688032632,1688033893,1261,20909,American Airlines,LAX,SFO
AA192,1688057696,1688058911,1215,18070,American Airlines,SFO,LAX
AA192,1688078814,1688088251,9437,15967,American Airlines,LAX,ORD
AA192,1688111898,1688112262,364,19391,American Airlines,ORD,MKE
AA192,1688133443,1688137082,3639,13414,American Airlines,MKE,ORD
AA192,1688160578,1688162040,1462,12957,American Airlines,ORD,MKE
AA192,1688181023,1688185966,4943,9970,American Airlines,MKE,ORD
AA192,1688199762,1688199783,21,18179,American Airlines,ORD,MKE
AA192,1688225689,1688227373,1684,4338,American Airlines,MKE,LAX
AA192,1688240333,1688245601,5268,4831,American Airlines,LAX,ORD
AA192,1688254256,1688254528,272,13810,American Airlines,ORD,MKE
AA192,1688269650,1688270356,706,10984,American Airlines,MKE,SFO
AA192,1688283895,1688283977,82,14967,American Airlines,SFO,LAX
AA192,1688303626,1688312863,9237,6812,American Airlines,LAX,ORD
AA192,1688324958,1688325282,324,13365,American Airlines,ORD,MKE
AA192,1688340146,1688341640,1494,11441,American Airlines,MKE,SFO
AA192,1688353874,1688354275,401,18052,American Airlines,SFO,LAX
AA192,1688372616,1688381953,9337,15566,American Airlines,LAX,ORD
AA192,1688401091,1688401127,36,18622,American Airlines,ORD,MKE
AA192,1688420779,1688421875,1096,12428,American Airlines,MKE,SFO
AA192,1688435586,1688444390,8804,13498,American Airlines,SFO,ORD
AA192,1688465895,1688467270,1375,12706,American Airlines,ORD,MKE
AA192,1688484991,1688495070,10079,17398,American Airlines,MKE,ORD
AA192,1688515396,1688516827,1431,21386,American Airlines,ORD,MKE
AA192,1688543563,1688552702,9139,7137,American Airlines,MKE,ORD
AA192,1688568447,1688569368,921,10602,American Airlines,ORD,MKE
AA192,1688587086,1688587467,381,10097,American Airlines,MKE,LAX
AA192,1688599403,1688603488,4085,20732,American Airlines,LAX,ORD
AA192,1688629073,1688630685,1612,19207,American Airlines,ORD,MKE
AA192,1688658445,1688658798,353,19146,American Airlines,MKE,SFO
AA192,1688686097,1688687531,1434,17597,American Airlines,SFO,LAX
AA192,1688714411,1688724246,9835,6445,American Airlines,LAX,ORD
AA192,1688740197,1688740861,664,6231,American Airlines,ORD,MKE
AA192,1688753607,1688754714,1107,20708,American Airlines,MKE,LAX
AA192,1688777559,1688785691,8132,7870,American Airlines,LAX,ORD
AA192,1688799441,1688800661,1220,11349,American Airlines,ORD,MKE
AA192,1688820730,1688822021,1291,16751,American Airlines,MKE,LAX
AA192,1688847416,1688854136,6720,11731,American Airlines,LAX,ORD
AA192,1688873884,1688875661,1777,7491,American Airlines,ORD,MKE
AA192,1688888704,1688889446,742,11411,American Airlines,MKE,LAX
AA192,1688909244,1688909497,253,8415,American Airlines,LAX,SFO
AA192,1688924567,1688929490,4923,11417,American Airlines,SFO,ORD
AA192,1688941925,1688943207,1282,14019,American Airlines,ORD,MKE
AA192,1688965994,1688969011,3017,19811,American Airlines,MKE,ORD
AA192,1688992720,1688993392,672,15391,American Airlines,ORD,MKE
AA192,1689011882,1689013271,1389,7841,American Airlines,MKE,LAX
AA192,1689029612,1689030237,625,8971,American Airlines,LAX,SFO
AA192,1689039493,1689040856,1363,21037,American Airlines,SFO,LAX
AA192,1689069494,1689071956,2462,14440,American Airlines,LAX,ORD
AA192,1689095970,1689096935,965,5341,American Airlines,ORD,MKE
AA192,1689103457,1689111142,7685,6413,American Airlines,MKE,ORD
AA192,1689121610,1689122848,1238,7469,American Airlines,ORD,MKE
AA192,1689139898,1689141151,1253,21183,American Airlines,MKE,LAX
AA192,1689171713,1689172623,910,12589,American Airlines,LAX,SFO
AA192,1689193469,1689193699,230,8311,American Airlines,SFO,LAX
AA192,1689212374,1689213134,760,7373,American Airlines,LAX,SFO
AA192,1689231031,1689237044,6013,5074,American Airlines,SFO,ORD
AA192,1689248473,1689249353,880,18852,American Airlines,ORD,MKE
AA192,1689273446,1689282868,9422,18228,American Airlines,MKE,ORD
AA192,1689304855,1689305179,324,11117,American Airlines,ORD,MKE
AA192,1689317531,1689321667,4136,18463,American Airlines,MKE,ORD
AA192,1689341793,1689342047,254,6537,American Airlines,ORD,MKE
AA192,1689349213,1689359381,10168,11708,American Airlines,MKE,ORD
AA192,1689371881,1689373092,1211,8955,American Airlines,ORD,MKE
AA192,1689391676,1689392319,643,6728,American Airlines,MKE,LAX
AA192,1689408912,1689418739,9827,4635,American Airlines,LAX,ORD
AA192,1689430451,1689431758,1307,12938,American Airlines,ORD,MKE
AA192,1689447527,1689451383,3856,4587,American Airlines,MKE,ORD
AA192,1689464675,1689465115,440,13861,American Airlines,ORD,MKE
AA192,1689479225,1689480362,1137,11589,American Airlines,MKE,LAX
AA192,1689496545,1689496663,118,7442,American Airlines,LAX,SFO
AA192,1689505845,1689508879,3034,16390,American Airlines,SFO,ORD
AA192,1689534473,1689534707,234,13324,American Airlines,ORD,MKE
AA192,1689558570,1689559489,919,6988,American Airlines,MKE,SFO
AA192,1689568405,1689569287,882,9308,American Airlines,SFO,LAX
AA192,1689583032,1689587036,4004,18083,American Airlines,LAX,ORD
AA192,1689605844,1689605918,74,5282,American Airlines,ORD,MKE
AA192,1689611595,1689611819,224,5054,American Airlines,MKE,SFO
AA192,1689621558,1689626680,5122,12303,American Airlines,SFO,ORD
AA192,1689648641,1689649641,1000,20148,American Airlines,ORD,MKE
AA192,1689677012,1689681458,4446,19851,American Airlines,MKE,ORD
AA192,1689703775,1689704825,1050,15333,American Airlines,ORD,MKE
AA192,1689726024,1689729356,3332,13444,American Airlines,MKE,ORD
AA192,1689749765,1689751099,1334,4204,American Airlines,ORD,MKE
AA192,1689759653,1689769861,10208,13039,American Airlines,MKE,ORD
AA192,1689783287,1689783842,555,10707,American Airlines,ORD,MKE
AA192,1689797041,1689804075,7034,3814,American Airlines,MKE,ORD
AA192,1689818151,1689819042,891,3776,American Airlines,ORD,MKE
AA192,1689832297,1689833108,811,8003,American Airlines,MKE,LAX
AA192,1689846351,1689848037,1686,5874,American Airlines,LAX,SFO
AA192,1689853956,1689854811,855,11184,American Airlines,SFO,LAX
AA192,1689873856,1689878415,4559,19329,American Airlines,LAX,ORD
AA192,1689906001,1689907748,1747,6246,American Airlines,ORD,MKE
AA192,1689916880,1689916961,81,6996,American Airlines,MKE,LAX
AA192,1689928338,1689928902,564,8096,American Airlines,LAX,SFO
AA192,1689941156,1689947463,6307,19015,American Airlines,SFO,ORD
AA192,1689973808,1689974088,280,5830,American Airlines,ORD,MKE
AA192,1689983457,1689993473,10016,17233,American Airlines,MKE,ORD
AA192,1690019337,1690019792,455,16886,American Airlines,ORD,MKE
AA192,1690039463,1690040894,1431,14959,American Airlines,MKE,SFO
AA192,1690058715,1690064016,5301,12502,American Airlines,SFO,ORD
AA192,1690084102,1690085749,1647,10835,American Airlines,ORD,MKE
AA192,1690105667,1690112566,6899,14956,American Airlines,MKE,ORD
AA192,1690137253,1690137838,585,10753,American Airlines,ORD,MKE
AA192,1690148965,1690149877,912,6688,American Airlines,MKE,SFO
AA192,1690158727,1690167843,9116,5231,American Airlines,SFO,ORD
AA192,1690179722,1690181499,1777,5676,American Airlines,ORD,MKE
AA192,1690190197,1690190887,690,10414,American Airlines,MKE,SFO
AA192,1690205127,1690206186,1059,6023,American Airlines,SFO,LAX
AA192,1690218048,1690219114,1066,18536,American Airlines,LAX,SFO
AA192,1690239335,1690241386,2051,18388,American Airlines,SFO,ORD
AA192,1690262925,1690264005,1080,21340,American Airlines,ORD,MKE
AA192,1690286073,1690291025,4952,16989,American Airlines,MKE,ORD
AA192,1690308873,1690309384,511,19922,American Airlines,ORD,MKE
AA192,1690336840,1690341797,4957,6200,American Airlines,MKE,ORD
AA192,1690354082,1690355766,1684,9754,American Airlines,ORD,MKE
AA192,1690374563,1690374641,78,5298,American Airlines,MKE,SFO
AA192,1690382152,1690385574,3422,14678,American Airlines,SFO,ORD
AA192,1690407665,1690409457,1792,16200,American Airlines,ORD,MKE
AA192,1690429120,1690429142,22,7830,American Airlines,MKE,LAX
AA192,1690444713,1690449194,4481,4852,American Airlines,LAX,ORD
AA192,1690458582,1690460046,1464,17486,American Airlines,ORD,MKE
AA192,1690484661,1690485988,1327,15592,American Airlines,MKE,SFO
AA192,1690510352,1690520257,9905,9264,American Airlines,SFO,ORD
AA192,1690530179,1690530894,715,9757,American Airlines,ORD,MKE
AA192,1690545691,1690545811,120,18052,American Airlines,MKE,LAX
AA192,1690571244,1690571343,99,8704,American Airlines,LAX,SFO
AA192,1690586127,1690586194,67,14107,American Airlines,SFO,LAX
AA192,1690607804,1690607822,18,15541,American Airlines,LAX,SFO
AA192,1690626158,1690632308,6150,20186,American Airlines,SFO,ORD
AA192,1690663156,1690663632,476,8343,American Airlines,ORD,MKE
AA192,1690672711,1690679712,7001,15419,American Airlines,MKE,ORD
AA192,1690699004,1690699312,308,5741,American Airlines,ORD,MKE
AA192,1690707031,1690710324,3293,8951,American Airlines,MKE,ORD
AA192,1690719705,1690720889,1184,18947,American Airlines,ORD,MKE
AA192,1690750332,1690751010,678,10203,American Airlines,MKE,LAX
AA192,1690769535,1690774048,4513,12236,American Airlines,LAX,ORD
AA192,1690788864,1690789695,831,9556,American Airlines,ORD,MKE
AA192,1690805607,1690808403,2796,20984,American Airlines,MKE,ORD
AA192,1690835062,1690836425,1363,12499,American Airlines,ORD,MKE
AA192,1690850204,1690852691,2487,8775,American Airlines,MKE,ORD
AA192,1690866890,1690868180,1290,12944,American Airlines,ORD,MKE
AA192,1690884102,1690888841,4739,19349,American Airlines,MKE,ORD
AA192,1690910031,1690911020,989,12820,American Airlines,ORD,MKE
AA192,1690930061,1690936289,6228,4657,American Airlines,MKE,ORD
AA192,1690942932,1690944675,1743,15005,American Airlines,ORD,MKE
AA192,1690970443,1690970900,457,15585,American Airlines,MKE,SFO
AA192,1690993449,1691000904,7455,19298,American Airlines,SFO,ORD
AA192,1691022096,1691022557,461,15550,American Airlines,ORD,MKE
AA192,1691039779,1691040070,291,14005,American Airlines,MKE,LAX
AA192,1691057515,1691058176,661,8995,American Airlines,LAX,SFO
AA192,1691069122,1691072653,3531,15597,American Airlines,SFO,ORD
AA192,1691097630,1691098773,1143,7348,American Airlines,ORD,MKE
AA192,1691116535,1691117984,1449,14644,American Airlines,MKE,SFO
AA192,1691142254,1691147855,5601,14669,American Airlines,SFO,ORD
AA192,1691169650,1691171058,1408,10444,American Airlines,ORD,MKE
AA192,1691188768,1691190346,1578,7427,American Airlines,MKE,LAX
AA192,1691204756,1691204889,133,17947,American Airlines,LAX,SFO
AA192,1691231851,1691232552,701,17781,American Airlines,SFO,LAX
AA192,1691256733,1691257619,886,11190,American Airlines,LAX,SFO
AA192,1691278481,1691278754,273,21144,American Airlines,SFO,LAX
AA192,1691307676,1691314074,6398,14765,American Airlines,LAX,ORD
AA192,1691334608,1691335134,526,8554,American Airlines,ORD,MKE
AA192,1691351421,1691352585,1164,8602,American Airlines,MKE,LAX
AA192,1691361638,1691364508,2870,7106,American Airlines,LAX,ORD
AA192,1691378844,1691379057,213,7790,American Airlines,ORD,MKE
AA192,1691395139,1691395353,214,7055,American Airlines,MKE,SFO
AA192,1691405105,1691413992,8887,13744,American Airlines,SFO,ORD
AA192,1691429580,1691429886,306,19314,American Airlines,ORD,MKE
AA192,1691453791,1691457514,3723,19196,American Airlines,MKE,ORD
AA192,1691478979,1691480462,1483,14920,American Airlines,ORD,MKE
AA192,1691505626,1691507103,1477,6460,American Airlines,MKE,LAX
AA192,1691516598,1691527037,10439,3744,American Airlines,LAX,ORD
AA192,1691531024,1691532112,1088,21356,American Airlines,ORD,MKE
AA192,1691554856,1691556334,1478,15400,American Airlines,MKE,SFO
AA192,1691581742,1691588744,7002,4298,American Airlines,SFO,ORD
AA192,1691600316,1691601653,1337,15968,American Airlines,ORD,MKE
AA192,1691617831,1691627318,9487,5407,American Airlines,MKE,ORD
AA192,1691640572,1691642115,1543,7239,American Airlines,ORD,MKE
AA192,1691650645,1691651410,765,9826,American Airlines,MKE,SFO
AA192,1691671825,1691676724,4899,13595,American Airlines,SFO,ORD
AA192,1691700272,1691701654,1382,13449,American Airlines,ORD,MKE
AA192,1691718779,1691727153,8374,13095,American Airlines,MKE,ORD
AA192,1691749217,1691750226,1009,17548,American Airlines,ORD,MKE
AA192,1691778102,1691782057,3955,14688,American Airlines,MKE,ORD
AA192,1691804708,1691806191,1483,10656,American Airlines,ORD,MKE
AA192,1691820244,1691821443,1199,6784,American Airlines,MKE,LAX
AA192,1691832320,1691832871,551,13361,American Airlines,LAX,SFO
AA192,1691849097,1691856267,7170,13076,American Airlines,SFO,ORD
AA192,1691870997,1691871563,566,9096,American Airlines,ORD,MKE
AA192,1691883815,1691884993,1178,10613,American Airlines,MKE,SFO
AA192,1691898619,1691906980,8361,4788,American Airlines,SFO,ORD
AA192,1691919972,1691920810,838,10141,American Airlines,ORD,MKE
AA192,1691935305,1691936195,890,17102,American Airlines,MKE,LAX
AA192,1691954365,1691958208,3843,18486,American Airlines,LAX,ORD
AA192,1691978221,1691978774,553,4119,American Airlines,ORD,MKE
AA192,1691985291,1691985789,498,19440,American Airlines,MKE,LAX
AA192,1692012954,1692014013,1059,4133,American Airlines,LAX,SFO
AA192,1692019830,1692021996,2166,20113,American Airlines,SFO,ORD
AA192,1692046651,1692047816,1165,5454,American Airlines,ORD,MKE
AA192,1692053305,1692054552,1247,16186,American Airlines,MKE,SFO
AA192,1692074263,1692075132,869,17894,American Airlines,SFO,LAX
AA192,1692099875,1692100351,476,7774,American Airlines,LAX,SFO
AA192,1692108562,1692116432,7870,18043,American Airlines,SFO,ORD
AA192,1692137254,1692138663,1409,6251,American Airlines,ORD,MKE
AA192,1692154847,1692156562,1715,9030,American Airlines,MKE,LAX
AA192,1692169738,1692170000,262,4817,American Airlines,LAX,SFO
AA192,1692176270,1692180717,4447,5560,American Airlines,SFO,ORD
AA192,1692191144,1692191314,170,14180,American Airlines,ORD,MKE
AA192,1692215488,1692224696,9208,12398,American Airlines,MKE,ORD
AA192,1692241346,1692241576,230,7206,American Airlines,ORD,MKE
AA192,1692253714,1692256277,2563,16474,American Airlines,MKE,ORD
AA192,1692280776,1692280783,7,13993,American Airlines,ORD,MKE
AA192,1692301429,1692301954,525,19733,American Airlines,MKE,SFO
AA192,1692326793,1692327668,875,6046,American Airlines,SFO,LAX
AA192,1692335373,1692336931,1558,7851,American Airlines,LAX,SFO
AA192,1692354573,1692360456,5883,4809,American Airlines,SFO,ORD
AA192,1692373990,1692374110,120,17647,American Airlines,ORD,MKE
AA192,1692392136,1692393745,1609,17444,American Airlines,MKE,LAX
AA192,1692415458,1692417298,1840,5934,American Airlines,LAX,ORD
AA192,1692428794,1692429603,809,6252,American Airlines,ORD,MKE
AA192,1692444668,1692446105,1437,7407,American Airlines,MKE,SFO
AA192,1692454269,1692454870,601,13065,American Airlines,SFO,LAX
AA192,1692468888,1692478348,9460,18853,American Airlines,LAX,ORD
AA192,1692505098,1692506640,1542,9656,American Airlines,ORD,MKE
AA192,1692524597,1692525875,1278,7127,American Airlines,MKE,LAX
AA192,1692543638,1692544976,1338,4616,American Airlines,LAX,SFO
AA192,1692558649,1692563320,4671,19050,American Airlines,SFO,ORD
AA192,1692584790,1692585198,408,16870,American Airlines,ORD,MKE
AA192,1692612402,1692614167,1765,16106,American Airlines,MKE,LAX
AA192,1692635348,1692641983,6635,5571,American Airlines,LAX,ORD
AA192,1692658262,1692659449,1187,19428,American Airlines,ORD,MKE
AA192,1692680420,1692687453,7033,19134,American Airlines,MKE,ORD
AA192,1692712641,1692713462,821,6365,American Airlines,ORD,MKE
AA192,1692723673,1692732071,8398,10450,American Airlines,MKE,ORD
AA192,1692747119,1692748036,917,14288,American Airlines,ORD,MKE
AA192,1692772908,1692782518,9610,7542,American Airlines,MKE,ORD
AA192,1692796139,1692797006,867,13968,American Airlines,ORD,MKE
AA192,1692819170,1692820099,929,13237,American Airlines,MKE,LAX
AA192,1692838191,1692841414,3223,12439,American Airlines,LAX,ORD
AA192,1692862081,1692862802,721,15749,American Airlines,ORD,MKE
AA192,1692880985,1692881059,74,15037,American Airlines,MKE,SFO
AA192,1692903080,1692905035,1955,4413,American Airlines,SFO,ORD
AA192,1692915723,1692915983,260,8427,American Airlines,ORD,MKE
AA192,1692928148,1692929398,1250,11943,American Airlines,MKE,SFO
AA192,1692947574,1692955738,8164,18901,American Airlines,SFO,ORD
AA192,1692982597,1692983386,789,14059,American Airlines,ORD,MKE
AA192,1693002222,1693002524,302,19333,American Airlines,MKE,LAX
AA192,1693027519,1693038259,10740,9620,American Airlines,LAX,ORD
AA192,1693053169,1693054641,1472,19472,American Airlines,ORD,MKE
AA192,1693083999,1693084275,276,12540,American Airlines,MKE,SFO
AA192,1693098633,1693099319,686,7156,American Airlines,SFO,LAX
AA192,1693111111,1693112273,1162,10754,American Airlines,LAX,SFO
AA192,1693123753,1693134473,10720,16031,American Airlines,SFO,ORD
AA192,1693150930,1693151625,695,10223,American Airlines,ORD,MKE
AA192,1693164926,1693165063,137,5390,American Airlines,MKE,SFO
AA192,1693177405,1693184658,7253,13471,American Airlines,SFO,ORD
AA192,1693199836,1693201158,1322,16200,American Airlines,ORD,MKE
AA192,1693227504,1693228887,1383,18564,American Airlines,MKE,LAX
AA192,1693256460,1693257037,577,12580,American Airlines,LAX,SFO
AA192,1693270899,1693272083,1184,11563,American Airlines,SFO,LAX
AA192,1693292540,1693292785,245,5143,American Airlines,LAX,SFO
AA192,1693302495,1693310426,7931,10708,American Airlines,SFO,ORD
AA192,1693325756,1693327379,1623,17545,American Airlines,ORD,MKE
AA192,1693348675,1693349034,359,13661,American Airlines,MKE,LAX
AA192,1693366418,1693374090,7672,9445,American Airlines,LAX,ORD
AA192,1693392970,1693393391,421,16146,American Airlines,ORD,MKE
AA192,1693416836,1693418589,1753,7618,American Airlines,MKE,SFO
AA192,1693429124,1693435157,6033,18105,American Airlines,SFO,ORD
AA192,1693457225,1693458939,1714,15211,American Airlines,ORD,MKE
AA192,1693475911,1693476002,91,20590,American Airlines,MKE,LAX
AA192,1693506713,1693513093,6380,20034,American Airlines,LAX,ORD
AA192,1693536492,1693537249,757,20922,American Airlines,ORD,MKE
AA192,1693564633,1693565488,855,15912,American Airlines,MKE,SFO
AA192,1693591062,1693591111,49,21399,American Airlines,SFO,LAX
AA192,1693613604,1693614779,1175,21096,American Airlines,LAX,SFO
AA192,1693645652,1693647379,1727,5764,American Airlines,SFO,LAX
AA192,1693661979,1693663456,1477,17980,American Airlines,LAX,SFO
AA192,1693691171,1693692468,1297,14306,American Airlines,SFO,LAX
AA192,1693716219,1693717283,1064,6550,American Airlines,LAX,SFO
AA192,1693729958,1693730248,290,13893,American Airlines,SFO,LAX
AA192,1693750378,1693756577,6199,8782,American Airlines,LAX,ORD
AA192,1693766505,1693767342,837,13109,American Airlines,ORD,MKE
AA192,1693788356,1693789605,1249,14131,American Airlines,MKE,LAX
AA192,1693808553,1693814064,5511,20330,American Airlines,LAX,ORD
AA192,1693844644,1693845410,766,19924,American Airlines,ORD,MKE
AA192,1693871106,1693871999,893,13940,American Airlines,MKE,LAX
AA192,1693896187,1693904394,8207,11121,American Airlines,LAX,ORD
AA192,1693921161,1693922356,1195,15629,American Airlines,ORD,MKE
AA192,1693942067,1693944451,2384,13290,American Airlines,MKE,ORD
AA192,1693965239,1693966719,1480,15115,American Airlines,ORD,MKE
AA192,1693985348,1693991157,5809,11088,American Airlines,MKE,ORD
AA192,1694012117,1694013507,1390,14384,American Airlines,ORD,MKE
AA192,1694037390,1694045215,7825,18307,American Airlines,MKE,ORD
AA192,1694067127,1694067746,619,21091,American Airlines,ORD,MKE
AA192,1694095197,1694095726,529,9780,American Airlines,MKE,LAX
AA192,1694108451,1694109511,1060,14450,American Airlines,LAX,SFO
AA192,1694134676,1694135685,1009,14122,American Airlines,SFO,LAX
AA192,1694154551,1694155460,909,15250,American Airlines,LAX,SFO
AA192,1694177386,1694178754,1368,15400,American Airlines,SFO,LAX
AA192,1694199431,1694199453,22,7279,American Airlines,LAX,SFO
AA192,1694214988,1694216188,1200,14442,American Airlines,SFO,LAX
AA192,1694237952,1694238227,275,10898,American Airlines,LAX,SFO
AA192,1694254959,1694255803,844,7711,American Airlines,SFO,LAX
AA192,1694266578,1694266742,164,20265,American Airlines,LAX,SFO
AA192,1694290450,1694301154,10704,10852,American Airlines,SFO,ORD
AA192,1694313595,1694313811,216,16122,American Airlines,ORD,MKE
AA192,1694338799,1694339127,328,20215,American Airlines,MKE,LAX
AA192,1694364285,1694365901,1616,6129,American Airlines,LAX,SFO
AA192,1694379719,1694386296,6577,4275,American Airlines,SFO,ORD
AA192,1694391340,1694392477,1137,4053,American Airlines,ORD,MKE
AA192,1694402845,1694403949,1104,10118,American Airlines,MKE,SFO
AA192,1694424077,1694425245,1168,21180,American Airlines,SFO,LAX
AA192,1694450886,1694451312,426,11539,American Airlines,LAX,SFO
AA192,1694471544,1694476462,4918,18544,American Airlines,SFO,ORD
AA192,1694500645,1694500658,13,11812,American Airlines,ORD,MKE
AA192,1694519330,1694519446,116,16580,American Airlines,MKE,LAX
AA192,1694546144,1694551217,5073,6283,American Airlines,LAX,ORD
AA192,1694568273,1694568462,189,4313,American Airlines,ORD,MKE
AA192,1694575289,1694581394,6105,15332,American Airlines,MKE,ORD
AA192,1694606433,1694607305,872,11255,American Airlines,ORD,MKE
AA192,1694622310,1694622995,685,13856,American Airlines,MKE,SFO
AA192,1694636920,1694638563,1643,20407,American Airlines,SFO,LAX
AA192,1694660769,1694661882,1113,17077,American Airlines,LAX,SFO
AA192,1694689447,1694689719,272,13348,American Airlines,SFO,LAX
AA192,1694707661,1694708391,730,8698,American Airlines,LAX,SFO
AA192,1694719177,1694725540,6363,8689,American Airlines,SFO,ORD
AA192,1694741466,1694742498,1032,16172,American Airlines,ORD,MKE
AA192,1694761829,1694764173,2344,13375,American Airlines,MKE,ORD
AA192,1694785777,1694786800,1023,16311,American Airlines,ORD,MKE
AA192,1694805767,1694805907,140,5236,American Airlines,MKE,LAX
AA192,1694818377,1694826740,8363,5030,American Airlines,LAX,ORD
AA192,1694839490,1694840472,982,18492,American Airlines,ORD,MKE
AA192,1694862438,1694863488,1050,18320,American Airlines,MKE,LAX
AA192,1694891694,1694892723,1029,14182,American Airlines,LAX,SFO
AA192,1694913078,1694913696,618,15968,American Airlines,SFO,LAX
AA192,1694934102,1694942110,8008,12683,American Airlines,LAX,ORD
AA192,1694962788,1694963805,1017,17596,American Airlines,ORD,MKE
AA192,1694983076,1694983183,107,7244,American Airlines,MKE,SFO
AA192,1694998697,1695000878,2181,15952,American Airlines,SFO,ORD
AA192,1695018675,1695020139,1464,15100,American Airlines,ORD,MKE
AA192,1695036722,1695038932,2210,15281,American Airlines,MKE,ORD
AA192,1695063470,1695063584,114,17123,American Airlines,ORD,MKE
AA192,1695090354,1695091665,1311,11079,American Airlines,MKE,SFO
AA192,1695109990,1695115770,5780,15833,American Airlines,SFO,ORD
AA192,1695137382,1695138826,1444,16623,American Airlines,ORD,MKE
AA192,1695165279,1695165762,483,13934,American Airlines,MKE,SFO
AA192,1695179872,1695180425,553,9215,American Airlines,SFO,LAX
AA192,1695195386,1695201485,6099,9741,American Airlines,LAX,ORD
AA192,1695213992,1695214877,885,15364,American Airlines,ORD,MKE
AA192,1695232758,1695233556,798,10154,American Airlines,MKE,LAX
AA192,1695252027,1695256300,4273,18462,American Airlines,LAX,ORD
AA192,1695283057,1695284825,1768,20844,American Airlines,ORD,MKE
AA192,1695312612,1695313053,441,15200,American Airlines,MKE,SFO
AA192,1695329540,1695339766,10226,4828,American Airlines,SFO,ORD
AA192,1695351990,1695352964,974,7902,American Airlines,ORD,MKE
AA192,1695367562,1695368773,1211,7576,American Airlines,MKE,SFO
AA192,1695385817,1695387119,1302,3981,American Airlines,SFO,LAX
AA192,1695391956,1695393066,1110,21075,American Airlines,LAX,SFO
AA192,1695424158,1695425314,1156,3815,American Airlines,SFO,LAX
AA192,1695433275,1695442144,8869,20097,American Airlines,LAX,ORD
AA192,1695464279,1695465716,1437,6693,American Airlines,ORD,MKE
AA192,1695478245,1695479513,1268,18646,American Airlines,MKE,LAX
AA192,1695498681,1695507890,9209,16400,American Airlines,LAX,ORD
AA192,1695534374,1695535246,872,13936,American Airlines,ORD,MKE
AA192,1695553152,1695554937,1785,16007,American Airlines,MKE,SFO
AA192,1695572422,1695574195,1773,12866,American Airlines,SFO,LAX
AA192,1695591141,1695598046,6905,15470,American Airlines,LAX,ORD
AA192,1695616989,1695617174,185,10311,American Airlines,ORD,MKE
AA192,1695634206,1695634215,9,8192,American Airlines,MKE,LAX
AA192,1695651306,1695659793,8487,20559,American Airlines,LAX,ORD
AA192,1695684256,1695684833,577,19593,American Airlines,ORD,MKE
AA192,1695712270,1695712939,669,5958,American Airlines,MKE,LAX
AA192,1695721950,1695725216,3266,20155,American Airlines,LAX,ORD
AA192,1695750014,1695750397,383,8584,American Airlines,ORD,MKE
AA192,1695765985,1695772540,6555,21290,American Airlines,MKE,ORD
AA192,1695794099,1695795727,1628,14348,American Airlines,ORD,MKE
AA192,1695812362,1695816146,3784,5682,American Airlines,MKE,ORD
AA192,1695826947,1695827526,579,7897,American Airlines,ORD,MKE
AA192,1695841315,1695842619,1304,11327,American Airlines,MKE,SFO
AA192,1695854999,1695859429,4430,13209,American Airlines,SFO,ORD
AA192,1695879648,1695880128,480,9881,American Airlines,ORD,MKE
AA192,1695896204,1695902865,6661,16449,American Airlines,MKE,ORD
AA192,1695926772,1695927396,624,5655,American Airlines,ORD,MKE
AA192,1695936585,1695945152,8567,20462,American Airlines,MKE,ORD
AA192,1695973295,1695973551,256,20704,American Airlines,ORD,MKE
AA192,1696002357,1696004038,1681,18231,American Airlines,MKE,SFO
AA192,1696029107,1696029529,422,14943,American Airlines,SFO,LAX
AA192,1696050360,1696051764,1404,13574,American Airlines,LAX,SFO
AA192,1696075526,1696082318,6792,3867,American Airlines,SFO,ORD
AA192,1696086964,1696087409,445,15762,American Airlines,ORD,MKE
AA192,1696113945,1696120375,6430,19077,American Airlines,MKE,ORD
AA192,1696143556,1696143738,182,14057,American Airlines,ORD,MKE
AA192,1696159607,1696161204,1597,17182,American Airlines,MKE,LAX
AA192,1696186268,1696194456,8188,19745,American Airlines,LAX,ORD
AA192,1696214571,1696216050,1479,11751,American Airlines,ORD,MKE
AA192,1696236550,1696245335,8785,18613,American Airlines,MKE,ORD
AA192,1696274613,1696274803,190,8045,American Airlines,ORD,MKE
AA192,1696286762,1696287235,473,4478,American Airlines,MKE,SFO
AA192,1696294953,1696295076,123,17701,American Airlines,SFO,LAX
AA192,1696322982,1696323221,239,4361,American Airlines,LAX,SFO
AA192,1696331042,1696335275,4233,6000,American Airlines,SFO,ORD
AA192,1696350553,1696350652,99,15892,American Airlines,ORD,MKE
AA192,1696372815,1696381130,8315,20841,American Airlines,MKE,ORD
AA192,1696402068,1696403587,1519,8942,American Airlines,ORD,MKE
AA192,1696417967,1696427573,9606,9547,American Airlines,MKE,ORD
AA192,1696442583,1696443738,1155,12876,American Airlines,ORD,MKE
AA192,1696462333,1696463968,1635,4270,American Airlines,MKE,LAX
AA192,1696474872,1696480820,5948,4355,American Airlines,LAX,ORD
AA192,1696491668,1696492520,852,17981,American Airlines,ORD,MKE
AA192,1696518515,1696520126,1611,15349,American Airlines,MKE,SFO
AA192,1696545923,1696546360,437,5427,American Airlines,SFO,LAX
AA192,1696561941,1696563779,1838,4282,American Airlines,LAX,ORD
AA192,1696573482,1696574080,598,5875,American Airlines,ORD,MKE
AA192,1696587929,1696589146,1217,4849,American Airlines,MKE,SFO
AA192,1696600568,1696602154,1586,20573,American Airlines,SFO,LAX
AA192,1696627765,1696628160,395,8984,American Airlines,LAX,SFO
AA192,1696640727,1696648343,7616,20595,American Airlines,SFO,ORD
AA192,1696676810,1696677232,422,12491,American Airlines,ORD,MKE
AA192,1696691973,1696699691,7718,14324,American Airlines,MKE,ORD
AA192,1696714548,1696716237,1689,10062,American Airlines,ORD,MKE
AA192,1696734385,1696735701,1316,8562,American Airlines,MKE,SFO
AA192,1696754492,1696754501,9,17721,American Airlines,SFO,LAX
AA192,1696772351,1696772894,543,11048,American Airlines,LAX,SFO
AA192,1696789956,1696790409,453,15007,American Airlines,SFO,LAX
AA192,1696810948,1696811909,961,16502,American Airlines,LAX,SFO
AA192,1696831064,1696831266,202,6042,American Airlines,SFO,LAX
AA192,1696843495,1696849372,5877,5759,American Airlines,LAX,ORD
AA192,1696859602,1696860786,1184,16584,American Airlines,ORD,MKE
AA192,1696879468,1696879894,426,12156,American Airlines,MKE,LAX
AA192,1696900220,1696908672,8452,8873,American Airlines,LAX,ORD
AA192,1696925037,1696925876,839,6986,American Airlines,ORD,MKE
AA192,1696938687,1696939733,1046,15524,American Airlines,MKE,SFO
AA192,1696955728,1696957980,2252,15609,American Airlines,SFO,ORD
AA192,1696981982,1696983173,1191,8667,American Airlines,ORD,MKE
AA192,1696994690,1697004112,9422,18459,American Airlines,MKE,ORD
AA192,1697024471,1697024627,156,17531,American Airlines,ORD,MKE
AA192,1697046100,1697047281,1181,10806,American Airlines,MKE,LAX
AA192,1697065912,1697066930,1018,11490,American Airlines,LAX,SFO
AA192,1697081054,1697086332,5278,16698,American Airlines,SFO,ORD
AA192,1697105773,1697106914,1141,16141,American Airlines,ORD,MKE
AA192,1697126544,1697126921,377,14455,American Airlines,MKE,LAX
AA192,1697150495,1697152112,1617,18454,American Airlines,LAX,SFO
AA192,1697180126,1697180741,615,10648,American Airlines,SFO,LAX
AA192,1697193269,1697194324,1055,11534,American Airlines,LAX,SFO
AA192,1697208341,1697209398,1057,13702,American Airlines,SFO,LAX
AA192,1697223347,1697224425,1078,7895,American Airlines,LAX,SFO
AA192,1697234552,1697238371,3819,12074,American Airlines,SFO,ORD
AA192,1697252183,1697253625,1442,5988,American Airlines,ORD,MKE
AA192,1697265930,1697272238,6308,4326,American Airlines,MKE,ORD
AA192,1697287136,1697288882,1746,4797,American Airlines,ORD,MKE
AA192,1697304453,1697312173,7720,5677,American Airlines,MKE,ORD
AA192,1697320743,1697322051,1308,18927,American Airlines,ORD,MKE
AA192,1697348096,1697349510,1414,20414,American Airlines,MKE,LAX
AA192,1697375862,1697385091,9229,4492,American Airlines,LAX,ORD
AA192,1697391577,1697393119,1542,16919,American Airlines,ORD,MKE
AA192,1697419777,1697421362,1585,13411,American Airlines,MKE,SFO
AA192,1697436980,1697437452,472,4060,American Airlines,SFO,LAX
AA192,1697444160,1697445262,1102,5063,American Airlines,LAX,SFO
AA192,1697459999,1697461626,1627,14548,American Airlines,SFO,LAX
AA192,1697478504,1697479403,899,16633,American Airlines,LAX,SFO
AA192,1697499221,1697501550,2329,14324,American Airlines,SFO,ORD
AA192,1697523243,1697523447,204,12285,American Airlines,ORD,MKE
AA192,1697541324,1697541824,500,12612,American Airlines,MKE,SFO
AA192,1697558462,1697559942,1480,19441,American Airlines,SFO,LAX
AA192,1697583877,1697584094,217,18753,American Airlines,LAX,SFO
AA192,1697610067,1697610913,846,14130,American Airlines,SFO,LAX
AA192,1697633126,1697641346,8220,6153,American Airlines,LAX,ORD
AA192,1697651242,1697652718,1476,5606,American Airlines,ORD,MKE
AA192,1697661161,1697662456,1295,6846,American Airlines,MKE,LAX
AA192,1697674036,1697679196,5160,19917,American Airlines,LAX,ORD
AA192,1697703880,1697705083,1203,11343,American Airlines,ORD,MKE
AA192,1697718505,1697719863,1358,15396,American Airlines,MKE,LAX
AA192,1697735632,1697742582,6950,11103,American Airlines,LAX,ORD
AA192,1697754660,1697755698,1038,19178,American Airlines,ORD,MKE
AA192,1697778637,1697779363,726,5375,American Airlines,MKE,SFO
AA192,1697788570,1697799239,10669,3893,American Airlines,SFO,ORD
AA192,1697809431,1697811027,1596,14483,American Airlines,ORD,MKE
AA192,1697829456,1697829820,364,11480,American Airlines,MKE,LAX
AA192,1697845601,1697855529,9928,15679,American Airlines,LAX,ORD
AA192,1697874163,1697874291,128,18998,American Airlines,ORD,MKE
AA192,1697896251,1697900356,4105,9532,American Airlines,MKE,ORD
AA192,1697918327,1697918866,539,18110,American Airlines,ORD,MKE
AA192,1697945427,1697949350,3923,12079,American Airlines,MKE,ORD
AA192,1697964570,1697966199,1629,19241,American Airlines,ORD,MKE
AA192,1697990654,1697990988,334,15109,American Airlines,MKE,SFO
AA192,1698010968,1698012177,1209,16979,American Airlines,SFO,LAX
AA192,1698033512,1698034861,1349,15230,American Airlines,LAX,SFO
AA192,1698056332,1698066469,10137,14170,American Airlines,SFO,ORD
AA192,1698084854,1698085879,1025,7493,American Airlines,ORD,MKE
AA192,1698098875,1698100055,1180,17517,American Airlines,MKE,SFO
AA192,1698123395,1698129577,6182,12889,American Airlines,SFO,ORD
AA192,1698143657,1698144327,670,4840,American Airlines,ORD,MKE
AA192,1698153491,1698154699,1208,9645,American Airlines,MKE,SFO
AA192,1698169108,1698169299,191,14562,American Airlines,SFO,LAX
AA192,1698193456,1698193811,355,17153,American Airlines,LAX,SFO
AA192,1698211640,1698212499,859,7134,American Airlines,SFO,LAX
AA192,1698225626,1698231091,5465,8669,American Airlines,LAX,ORD
AA192,1698244909,1698245119,210,9162,American Airlines,ORD,MKE
AA192,1698263054,1698263754,700,18269,American Airlines,MKE,LAX
AA192,1698286310,1698288846,2536,7709,American Airlines,LAX,ORD
AA192,1698297270,1698298587,1317,10516,American Airlines,ORD,MKE
AA192,1698312345,1698313728,1383,20254,American Airlines,MKE,LAX
AA192,1698338437,1698345009,6572,11416,American Airlines,LAX,ORD
AA192,1698361181,1698361412,231,10234,American Airlines,ORD,MKE
AA192,1698378684,1698385423,6739,15535,American Airlines,MKE,ORD
AA192,1698405131,1698405643,512,10149,American Airlines,ORD,MKE
AA192,1698426339,1698432377,6038,17211,American Airlines,MKE,ORD
AA192,1698457271,1698458255,984,5770,American Airlines,ORD,MKE
AA192,1698468700,1698472867,4167,13409,American Airlines,MKE,ORD
AA192,1698490437,1698491110,673,12117,American Airlines,ORD,MKE
DL720,1682959659,1682965104,5445,7555,Delta Air Lines,SFO,ORD
DL720,1682981771,1682982483,712,8677,Delta Air Lines,ORD,MKE
DL720,1682998433,1682999900,1467,20019,Delta Air Lines,MKE,LAX
DL720,1683026472,1683030161,3689,14906,Delta Air Lines,LAX,ORD
DL720,1683046396,1683047451,1055,21287,Delta Air Lines,ORD,MKE
DL720,1683079482,1683080672,1190,17349,Delta Air Lines,MKE,SFO
DL720,1683105784,1683111368,5584,11129,Delta Air Lines,SFO,ORD
DL720,1683124006,1683124929,923,12437,Delta Air Lines,ORD,MKE
DL720,1683140308,1683140819,511,17563,Delta Air Lines,MKE,SFO
DL720,1683166610,1683171373,4763,9307,Delta Air Lines,SFO,ORD
DL720,1683182300,1683183068,768,7141,Delta Air Lines,ORD,MKE
DL720,1683190501,1683196245,5744,13565,Delta Air Lines,MKE,ORD
DL720,1683214205,1683214580,375,5936,Delta Air Lines,ORD,MKE
DL720,1683229427,1683230493,1066,16070,Delta Air Lines,MKE,LAX
DL720,1683248175,1683250571,2396,17234,Delta Air Lines,LAX,ORD
DL720,1683277171,1683277932,761,16057,Delta Air Lines,ORD,MKE
DL720,1683301005,1683311245,10240,5326,Delta Air Lines,MKE,ORD
DL720,1683321853,1683322366,513,12026,Delta Air Lines,ORD,MKE
DL720,1683339439,1683339781,342,21309,Delta Air Lines,MKE,LAX
DL720,1683369522,1683371026,1504,6729,Delta Air Lines,LAX,SFO
DL720,1683386868,1683387205,337,6066,Delta Air Lines,SFO,LAX
DL720,1683403101,1683404224,1123,17825,Delta Air Lines,LAX,SFO
DL720,1683428362,1683429081,719,9684,Delta Air Lines,SFO,LAX
DL720,1683448589,1683449164,575,9620,Delta Air Lines,LAX,SFO
DL720,1683465267,1683467998,2731,14779,Delta Air Lines,SFO,ORD
DL720,1683485973,1683487744,1771,17063,Delta Air Lines,ORD,MKE
DL720,1683515036,1683515749,713,17261,Delta Air Lines,MKE,LAX
DL720,1683540226,1683542352,2126,9707,Delta Air Lines,LAX,ORD
DL720,1683559080,1683559532,452,13557,Delta Air Lines,ORD,MKE
DL720,1683574445,1683574877,432,4261,Delta Air Lines,MKE,SFO
DL720,1683589155,1683590140,985,17887,Delta Air Lines,SFO,LAX
DL720,1683613439,1683614257,818,20025,Delta Air Lines,LAX,SFO
DL720,1683642407,1683646760,4353,14904,Delta Air Lines,SFO,ORD
DL720,1683669930,1683670424,494,18762,Delta Air Lines,ORD,MKE
DL720,1683696868,1683700224,3356,14788,Delta Air Lines,MKE,ORD
DL720,1683717982,1683718015,33,4770,Delta Air Lines,ORD,MKE
DL720,1683727830,1683733922,6092,18245,Delta Air Lines,MKE,ORD
DL720,1683759154,1683760304,1150,4618,Delta Air Lines,ORD,MKE
DL720,1683769735,1683772777,3042,21126,Delta Air Lines,MKE,ORD
DL720,1683796611,1683798126,1515,20449,Delta Air Lines,ORD,MKE
DL720,1683822549,1683822861,312,12467,Delta Air Lines,MKE,SFO
DL720,1683837248,1683846715,9467,8305,Delta Air Lines,SFO,ORD
DL720,1683861773,1683862584,811,20905,Delta Air Lines,ORD,MKE
DL720,1683889731,1683891342,1611,20271,Delta Air Lines,MKE,SFO
DL720,1683917117,1683918423,1306,11894,Delta Air Lines,SFO,LAX
DL720,1683938819,1683938999,180,15700,Delta Air Lines,LAX,SFO
DL720,1683965025,1683971768,6743,4270,Delta Air Lines,SFO,ORD
DL720,1683985709,1683986249,540,13428,Delta Air Lines,ORD,MKE
DL720,1684007734,1684008079,345,6472,Delta Air Lines,MKE,SFO
DL720,1684020625,1684021652,1027,10368,Delta Air Lines,SFO,LAX
DL720,1684042537,1684043086,549,8014,Delta Air Lines,LAX,SFO
DL720,1684053032,1684062440,9408,7931,Delta Air Lines,SFO,ORD
DL720,1684078882,1684079435,553,15684,Delta Air Lines,ORD,MKE
DL720,1684098282,1684099204,922,16018,Delta Air Lines,MKE,LAX
DL720,1684116404,1684118141,1737,21066,Delta Air Lines,LAX,SFO
DL720,1684139329,1684140963,1634,17971,Delta Air Lines,SFO,LAX
DL720,1684162357,1684167904,5547,5924,Delta Air Lines,LAX,ORD
DL720,1684176651,1684177189,538,16374,Delta Air Lines,ORD,MKE
DL720,1684196799,1684202352,5553,16536,Delta Air Lines,MKE,ORD
DL720,1684227061,1684228666,1605,17357,Delta Air Lines,ORD,MKE
DL720,1684247770,1684249077,1307,17537,Delta Air Lines,MKE,LAX
DL720,1684275760,1684276538,778,16001,Delta Air Lines,LAX,SFO
DL720,1684298296,1684307833,9537,4114,Delta Air Lines,SFO,ORD
DL720,1684320975,1684321763,788,16045,Delta Air Lines,ORD,MKE
DL720,1684345403,1684346979,1576,11765,Delta Air Lines,MKE,LAX
DL720,1684361753,1684362347,594,16548,Delta Air Lines,LAX,SFO
DL720,1684381159,1684382315,1156,11977,Delta Air Lines,SFO,LAX
DL720,1684395685,1684400058,4373,14935,Delta Air Lines,LAX,ORD
DL720,1684416904,1684417931,1027,13716,Delta Air Lines,ORD,MKE
DL720,1684437893,1684438864,971,5432,Delta Air Lines,MKE,LAX
DL720,1684447645,1684457564,9919,5744,Delta Air Lines,LAX,ORD
DL720,1684464648,1684465954,1306,19875,Delta Air Lines,ORD,MKE
DL720,1684491178,1684492210,1032,19770,Delta Air Lines,MKE,LAX
DL720,1684518329,1684518986,657,12817,Delta Air Lines,LAX,SFO
DL720,1684534952,1684539172,4220,9883,Delta Air Lines,SFO,ORD
DL720,1684559470,1684559527,57,8193,Delta Air Lines,ORD,MKE
DL720,1684577596,1684578268,672,15283,Delta Air Lines,MKE,SFO
DL720,1684598769,1684600679,1910,16375,Delta Air Lines,SFO,ORD
DL720,1684620330,1684621156,826,10402,Delta Air Lines,ORD,MKE
DL720,1684636462,1684639800,3338,11689,Delta Air Lines,MKE,ORD
DL720,1684655072,1684655756,684,20832,Delta Air Lines,ORD,MKE
DL720,1684681286,1684689850,8564,10480,Delta Air Lines,MKE,ORD
DL720,1684704651,1684705632,981,13687,Delta Air Lines,ORD,MKE
DL720,1684719614,1684719930,316,5287,Delta Air Lines,MKE,LAX
DL720,1684734117,1684739933,5816,6128,Delta Air Lines,LAX,ORD
DL720,1684751106,1684752757,1651,13754,Delta Air Lines,ORD,MKE
DL720,1684769860,1684769981,121,13299,Delta Air Lines,MKE,LAX
DL720,1684785919,1684796397,10478,5056,Delta Air Lines,LAX,ORD
DL720,1684812077,1684812464,387,18451,Delta Air Lines,ORD,MKE
DL720,1684831844,1684832866,1022,11836,Delta Air Lines,MKE,LAX
DL720,1684849989,1684851380,1391,8496,Delta Air Lines,LAX,SFO
DL720,1684863545,1684865596,2051,15255,Delta Air Lines,SFO,ORD
DL720,1684891104,1684891348,244,9693,Delta Air Lines,ORD,MKE
DL720,1684911133,1684911712,579,7295,Delta Air Lines,MKE,SFO
DL720,1684921947,1684921964,17,14081,Delta Air Lines,SFO,LAX
DL720,1684937259,1684938695,1436,11723,Delta Air Lines,LAX,SFO
DL720,1684958801,1684968593,9792,19740,Delta Air Lines,SFO,ORD
DL720,1684995444,1684996408,964,11068,Delta Air Lines,ORD,MKE
DL720,1685017523,1685025457,7934,13921,Delta Air Lines,MKE,ORD
DL720,1685045574,1685046183,609,19211,Delta Air Lines,ORD,MKE
DL720,1685076176,1685077387,1211,13929,Delta Air Lines,MKE,LAX
DL720,1685095253,1685101618,6365,14148,Delta Air Lines,LAX,ORD
DL720,1685125886,1685126944,1058,15884,Delta Air Lines,ORD,MKE
DL720,1685145096,1685154953,9857,19035,Delta Air Lines,MKE,ORD
DL720,1685177485,1685179265,1780,17514,Delta Air Lines,ORD,MKE
DL720,1685202083,1685205031,2948,19777,Delta Air Lines,MKE,ORD
DL720,1685233540,1685235123,1583,6455,Delta Air Lines,ORD,MKE
DL720,1685242424,1685243965,1541,11768,Delta Air Lines,MKE,LAX
DL720,1685260590,1685265273,4683,8155,Delta Air Lines,LAX,ORD
DL720,1685277639,1685278666,1027,17133,Delta Air Lines,ORD,MKE
DL720,1685297390,1685299858,2468,15056,Delta Air Lines,MKE,ORD
DL720,1685315305,1685316435,1130,17074,Delta Air Lines,ORD,MKE
DL720,1685339380,1685345002,5622,12113,Delta Air Lines,MKE,ORD
DL720,1685357303,1685358894,1591,4348,Delta Air Lines,ORD,MKE
DL720,1685366725,1685366974,249,17941,Delta Air Lines,MKE,LAX
DL720,1685391909,1685393004,1095,5826,Delta Air Lines,LAX,SFO
DL720,1685399681,1685405187,5506,9735,Delta Air Lines,SFO,ORD
DL720,1685420615,1685420864,249,8443,Delta Air Lines,ORD,MKE
DL720,1685433379,1685434386,1007,8097,Delta Air Lines,MKE,SFO
DL720,1685444785,1685452432,7647,9436,Delta Air Lines,SFO,ORD
DL720,1685465275,1685466539,1264,4141,Delta Air Lines,ORD,MKE
DL720,1685474974,1685475598,624,9118,Delta Air Lines,MKE,LAX
DL720,1685484843,1685492453,7610,4242,Delta Air Lines,LAX,ORD
DL720,1685500207,1685500977,770,12654,Delta Air Lines,ORD,MKE
DL720,1685517202,1685518729,1527,6415,Delta Air Lines,MKE,LAX
DL720,1685531503,1685532764,1261,12645,Delta Air Lines,LAX,SFO
DL720,1685553996,1685554983,987,7240,Delta Air Lines,SFO,LAX
DL720,1685572821,1685574267,1446,3929,Delta Air Lines,LAX,SFO
DL720,1685579937,1685589725,9788,15299,Delta Air Lines,SFO,ORD
DL720,1685611979,1685613499,1520,14677,Delta Air Lines,ORD,MKE
DL720,1685629509,1685629806,297,20708,Delta Air Lines,MKE,LAX
DL720,1685660561,1685662338,1777,20769,Delta Air Lines,LAX,SFO
DL720,1685683329,1685685838,2509,9510,Delta Air Lines,SFO,ORD
DL720,1685698814,1685698978,164,19475,Delta Air Lines,ORD,MKE
DL720,1685727724,1685728438,714,9727,Delta Air Lines,MKE,SFO
DL720,1685740717,1685742227,1510,10530,Delta Air Lines,SFO,LAX
DL720,1685761071,1685765804,4733,19387,Delta Air Lines,LAX,ORD
DL720,1685785941,1685787331,1390,3651,Delta Air Lines,ORD,MKE
DL720,1685793832,1685794537,705,12346,Delta Air Lines,MKE,SFO
DL720,1685807126,1685812227,5101,19941,Delta Air Lines,SFO,ORD
DL720,1685836032,1685836336,304,11048,Delta Air Lines,ORD,MKE
DL720,1685849065,1685858904,9839,9521,Delta Air Lines,MKE,ORD
DL720,1685870532,1685871047,515,11448,Delta Air Lines,ORD,MKE
DL720,1685883842,1685885013,1171,11409,Delta Air Lines,MKE,SFO
DL720,1685904834,1685906358,1524,3899,Delta Air Lines,SFO,LAX
DL720,1685912232,1685913218,986,17712,Delta Air Lines,LAX,SFO
DL720,1685937645,1685939880,2235,20839,Delta Air Lines,SFO,ORD
DL720,1685963485,1685964714,1229,12607,Delta Air Lines,ORD,MKE
DL720,1685981199,1685981770,571,14051,Delta Air Lines,MKE,LAX
DL720,1686005269,1686007047,1778,7627,Delta Air Lines,LAX,SFO
DL720,1686017569,1686018280,711,5351,Delta Air Lines,SFO,LAX
DL720,1686025501,1686031498,5997,18849,Delta Air Lines,LAX,ORD
DL720,1686058475,1686060233,1758,17817,Delta Air Lines,ORD,MKE
DL720,1686082942,1686083206,264,15773,Delta Air Lines,MKE,LAX
DL720,1686100414,1686101759,1345,13747,Delta Air Lines,LAX,SFO
DL720,1686121732,1686123447,1715,7985,Delta Air Lines,SFO,LAX
DL720,1686132187,1686137832,5645,4839,Delta Air Lines,LAX,ORD
DL720,1686149213,1686150379,1166,13051,Delta Air Lines,ORD,MKE
DL720,1686169221,1686169899,678,19453,Delta Air Lines,MKE,SFO
DL720,1686196493,1686197147,654,18129,Delta Air Lines,SFO,LAX
DL720,1686224222,1686234299,10077,3953,Delta Air Lines,LAX,ORD
DL720,1686240206,1686240323,117,18713,Delta Air Lines,ORD,MKE
DL720,1686259746,1686260261,515,18344,Delta Air Lines,MKE,SFO
DL720,1686280871,1686281083,212,4217,Delta Air Lines,SFO,LAX
DL720,1686290887,1686292516,1629,12697,Delta Air Lines,LAX,SFO
DL720,1686309985,1686311541,1556,15138,Delta Air Lines,SFO,LAX
DL720,1686329093,1686332504,3411,16523,Delta Air Lines,LAX,ORD
DL720,1686358457,1686359591,1134,8748,Delta Air Lines,ORD,MKE
DL720,1686378335,1686378947,612,8889,Delta Air Lines,MKE,LAX
DL720,1686388512,1686390600,2088,12810,Delta Air Lines,LAX,ORD
DL720,1686405029,1686406558,1529,16576,Delta Air Lines,ORD,MKE
DL720,1686423504,1686424491,987,11762,Delta Air Lines,MKE,SFO
DL720,1686441241,1686446322,5081,13519,Delta Air Lines,SFO,ORD
DL720,1686464019,1686464416,397,19988,Delta Air Lines,ORD,MKE
DL720,1686490227,1686490382,155,8895,Delta Air Lines,MKE,SFO
DL720,1686501773,1686502616,843,8554,Delta Air Lines,SFO,LAX
DL720,1686512709,1686513377,668,5555,Delta Air Lines,LAX,SFO
DL720,1686519457,1686522409,2952,20957,Delta Air Lines,SFO,ORD
DL720,1686550076,1686551379,1303,12665,Delta Air Lines,ORD,MKE
DL720,1686572491,1686577342,4851,8772,Delta Air Lines,MKE,ORD
DL720,1686596744,1686597300,556,5480,Delta Air Lines,ORD,MKE
DL720,1686610254,1686612041,1787,21027,Delta Air Lines,MKE,LAX
DL720,1686636682,1686641298,4616,4404,Delta Air Lines,LAX,ORD
DL720,1686648804,1686649037,233,9436,Delta Air Lines,ORD,MKE
DL720,1686665038,1686665083,45,10480,Delta Air Lines,MKE,LAX
DL720,1686685512,1686687292,1780,12716,Delta Air Lines,LAX,SFO
DL720,1686707606,1686714645,7039,17376,Delta Air Lines,SFO,ORD
DL720,1686736712,1686738211,1499,17127,Delta Air Lines,ORD,MKE
DL720,1686755340,1686760079,4739,10914,Delta Air Lines,MKE,ORD
DL720,1686771366,1686771699,333,14592,Delta Air Lines,ORD,MKE
DL720,1686795708,1686804469,8761,4194,Delta Air Lines,MKE,ORD
DL720,1686817914,1686819496,1582,18509,Delta Air Lines,ORD,MKE
DL720,1686848260,1686850025,1765,12544,Delta Air Lines,MKE,SFO
DL720,1686866042,1686870180,4138,10224,Delta Air Lines,SFO,ORD
DL720,1686887180,1686887962,782,9453,Delta Air Lines,ORD,MKE
DL720,1686906723,1686912258,5535,19585,Delta Air Lines,MKE,ORD
DL720,1686940870,1686942550,1680,16947,Delta Air Lines,ORD,MKE
DL720,1686963456,1686963631,175,18996,Delta Air Lines,MKE,SFO
DL720,1686991746,1687000868,9122,9516,Delta Air Lines,SFO,ORD
DL720,1687012557,1687014316,1759,12304,Delta Air Lines,ORD,MKE
DL720,1687028753,1687028815,62,4567,Delta Air Lines,MKE,LAX
DL720,1687035443,1687036890,1447,19271,Delta Air Lines,LAX,SFO
DL720,1687065031,1687071657,6626,19058,Delta Air Lines,SFO,ORD
DL720,1687094387,1687095961,1574,19219,Delta Air Lines,ORD,MKE
DL720,1687116620,1687126915,10295,3992,Delta Air Lines,MKE,ORD
DL720,1687137047,1687137529,482,10458,Delta Air Lines,ORD,MKE
DL720,1687154701,1687156488,1787,7706,Delta Air Lines,MKE,LAX
DL720,1687174356,1687175083,727,11827,Delta Air Lines,LAX,SFO
DL720,1687197634,1687198134,500,3787,Delta Air Lines,SFO,LAX
DL720,1687207183,1687212575,5392,18204,Delta Air Lines,LAX,ORD
DL720,1687234323,1687235556,1233,18986,Delta Air Lines,ORD,MKE
DL720,1687257510,1687258058,548,5248,Delta Air Lines,MKE,SFO
DL720,1687267542,1687267570,28,7441,Delta Air Lines,SFO,LAX
DL720,1687282307,1687290443,8136,5082,Delta Air Lines,LAX,ORD
DL720,1687301226,1687301227,1,4029,Delta Air Lines,ORD,MKE
DL720,1687309878,1687311662,1784,20796,Delta Air Lines,MKE,LAX
DL720,1687336249,1687336509,260,13729,Delta Air Lines,LAX,SFO
DL720,1687351482,1687353626,2144,15993,Delta Air Lines,SFO,ORD
DL720,1687372268,1687373914,1646,11228,Delta Air Lines,ORD,MKE
DL720,1687391585,1687397197,5612,21376,Delta Air Lines,MKE,ORD
DL720,1687425210,1687425976,766,18012,Delta Air Lines,ORD,MKE
DL720,1687447704,1687448741,1037,4190,Delta Air Lines,MKE,SFO
DL720,1687454290,1687454467,177,11749,Delta Air Lines,SFO,LAX
DL720,1687475512,1687480603,5091,5940,Delta Air Lines,LAX,ORD
DL720,1687493138,1687493341,203,9120,Delta Air Lines,ORD,MKE
DL720,1687512254,1687513180,926,16384,Delta Air Lines,MKE,SFO
DL720,1687539024,1687547716,8692,6387,Delta Air Lines,SFO,ORD
DL720,1687560859,1687562492,1633,7473,Delta Air Lines,ORD,MKE
DL720,1687574633,1687575631,998,14307,Delta Air Lines,MKE,SFO
DL720,1687598793,1687599604,811,9345,Delta Air Lines,SFO,LAX
DL720,1687617086,1687627083,9997,17273,Delta Air Lines,LAX,ORD
DL720,1687649430,1687649810,380,21455,Delta Air Lines,ORD,MKE
DL720,1687675447,1687679494,4047,16783,Delta Air Lines,MKE,ORD
DL720,1687700502,1687700781,279,12075,Delta Air Lines,ORD,MKE
DL720,1687717022,1687717621,599,7759,Delta Air Lines,MKE,LAX
DL720,1687729794,1687733459,3665,8521,Delta Air Lines,LAX,ORD
DL720,1687749936,1687751354,1418,15166,Delta Air Lines,ORD,MKE
DL720,1687769792,1687770189,397,14913,Delta Air Lines,MKE,SFO
DL720,1687795046,1687804507,9461,20404,Delta Air Lines,SFO,ORD
DL720,1687831954,1687832941,987,21518,Delta Air Lines,ORD,MKE
DL720,1687855729,1687855804,75,21436,Delta Air Lines,MKE,LAX
DL720,1687881818,1687882380,562,20491,Delta Air Lines,LAX,SFO
DL720,1687903460,1687908420,4960,4752,Delta Air Lines,SFO,ORD
DL720,1687917656,1687919148,1492,13528,Delta Air Lines,ORD,MKE
DL720,1687938050,1687942050,4000,4040,Delta Air Lines,MKE,ORD
DL720,1687956309,1687957006,697,19268,Delta Air Lines,ORD,MKE
DL720,1687982466,1687983042,576,11235,Delta Air Lines,MKE,SFO
DL720,1688001653,1688011447,9794,16865,Delta Air Lines,SFO,ORD
DL720,1688038589,1688038752,163,13583,Delta Air Lines,ORD,MKE
DL720,1688058551,1688058865,314,7439,Delta Air Lines,MKE,LAX
DL720,1688075066,1688082416,7350,16939,Delta Air Lines,LAX,ORD
DL720,1688100302,1688102057,1755,18517,Delta Air Lines,ORD,MKE
DL720,1688130212,1688133987,3775,16594,Delta Air Lines,MKE,ORD
DL720,1688157219,1688158408,1189,7446,Delta Air Lines,ORD,MKE
DL720,1688169010,1688171385,2375,18674,Delta Air Lines,MKE,ORD
DL720,1688197771,1688198455,684,19998,Delta Air Lines,ORD,MKE
DL720,1688219996,1688222390,2394,7915,Delta Air Lines,MKE,ORD
DL720,1688232761,1688233581,820,9924,Delta Air Lines,ORD,MKE
DL720,1688245304,1688246845,1541,5765,Delta Air Lines,MKE,SFO
DL720,1688260003,1688266257,6254,16681,Delta Air Lines,SFO,ORD
DL720,1688285977,1688287297,1320,12062,Delta Air Lines,ORD,MKE
DL720,1688302579,1688303972,1393,11330,Delta Air Lines,MKE,LAX
DL720,1688323194,1688324280,1086,16669,Delta Air Lines,LAX,SFO
DL720,1688348608,1688356593,7985,12985,Delta Air Lines,SFO,ORD
DL720,1688372848,1688373421,573,17599,Delta Air Lines,ORD,MKE
DL720,1688399849,1688401284,1435,13042,Delta Air Lines,MKE,SFO
DL720,1688422374,1688422671,297,15664,Delta Air Lines,SFO,LAX
DL720,1688445288,1688456000,10712,12315,Delta Air Lines,LAX,ORD
DL720,1688470387,1688472135,1748,3654,Delta Air Lines,ORD,MKE
DL720,1688482261,1688484393,2132,11899,Delta Air Lines,MKE,ORD
DL720,1688500165,1688501329,1164,4703,Delta Air Lines,ORD,MKE
DL720,1688507699,1688514008,6309,18108,Delta Air Lines,MKE,ORD
DL720,1688535536,1688537021,1485,21186,Delta Air Lines,ORD,MKE
DL720,1688561205,1688562471,1266,12831,Delta Air Lines,MKE,SFO
DL720,1688576320,1688576563,243,14557,Delta Air Lines,SFO,LAX
DL720,1688600619,1688608969,8350,6544,Delta Air Lines,LAX,ORD
DL720,1688624101,1688624159,58,20417,Delta Air Lines,ORD,MKE
DL720,1688648897,1688651922,3025,15106,Delta Air Lines,MKE,ORD
DL720,1688671279,1688671815,536,8394,Delta Air Lines,ORD,MKE
DL720,1688681472,1688688159,6687,5931,Delta Air Lines,MKE,ORD
DL720,1688704426,1688705491,1065,19723,Delta Air Lines,ORD,MKE
DL720,1688730730,1688731703,973,14416,Delta Air Lines,MKE,LAX
DL720,1688749473,1688750064,591,5186,Delta Air Lines,LAX,SFO
DL720,1688757514,1688758222,708,11612,Delta Air Lines,SFO,LAX
DL720,1688771560,1688772907,1347,5658,Delta Air Lines,LAX,SFO
DL720,1688784332,1688792419,8087,13271,Delta Air Lines,SFO,ORD
DL720,1688815464,1688815803,339,4443,Delta Air Lines,ORD,MKE
DL720,1688820593,1688825036,4443,13288,Delta Air Lines,MKE,ORD
DL720,1688844253,1688845305,1052,9363,Delta Air Lines,ORD,MKE
DL720,1688857891,1688858816,925,15312,Delta Air Lines,MKE,SFO
DL720,1688877631,1688882376,4745,3901,Delta Air Lines,SFO,ORD
DL720,1688888642,1688889653,1011,3784,Delta Air Lines,ORD,MKE
DL720,1688896038,1688896603,565,11385,Delta Air Lines,MKE,SFO
DL720,1688912214,1688912943,729,13527,Delta Air Lines,SFO,LAX
DL720,1688928129,1688936465,8336,11657,Delta Air Lines,LAX,ORD
DL720,1688954058,1688955236,1178,14021,Delta Air Lines,ORD,MKE
DL720,1688979747,1688980885,1138,7692,Delta Air Lines,MKE,LAX
DL720,1688995765,1689003085,7320,8769,Delta Air Lines,LAX,ORD
DL720,1689012297,1689013520,1223,9186,Delta Air Lines,ORD,MKE
DL720,1689032345,1689033518,1173,20135,Delta Air Lines,MKE,SFO
DL720,1689055204,1689055356,152,7998,Delta Air Lines,SFO,LAX
DL720,1689066737,1689071685,4948,18816,Delta Air Lines,LAX,ORD
DL720,1689093270,1689093785,515,19654,Delta Air Lines,ORD,MKE
DL720,1689123572,1689125169,1597,18705,Delta Air Lines,MKE,LAX
DL720,1689144177,1689149954,5777,5056,Delta Air Lines,LAX,ORD
DL720,1689156031,1689157461,1430,15917,Delta Air Lines,ORD,MKE
DL720,1689181329,1689182507,1178,21587,Delta Air Lines,MKE,LAX
DL720,1689213560,1689217606,4046,17637,Delta Air Lines,LAX,ORD
DL720,1689241228,1689241838,610,21138,Delta Air Lines,ORD,MKE
DL720,1689272530,1689276502,3972,9938,Delta Air Lines,MKE,ORD
DL720,1689286613,1689287698,1085,4400,Delta Air Lines,ORD,MKE
DL720,1689299656,1689304212,4556,6957,Delta Air Lines,MKE,ORD
DL720,1689317986,1689319242,1256,6780,Delta Air Lines,ORD,MKE
DL720,1689336110,1689343111,7001,7759,Delta Air Lines,MKE,ORD
DL720,1689358432,1689358467,35,10684,Delta Air Lines,ORD,MKE
DL720,1689375775,1689376407,632,19562,Delta Air Lines,MKE,LAX
DL720,1689400565,1689403949,3384,6574,Delta Air Lines,LAX,ORD
DL720,1689414296,1689414985,689,16739,Delta Air Lines,ORD,MKE
DL720,1689438912,1689440488,1576,13257,Delta Air Lines,MKE,SFO
DL720,1689455538,1689457144,1606,6443,Delta Air Lines,SFO,LAX
DL720,1689470115,1689479560,9445,20878,Delta Air Lines,LAX,ORD
DL720,1689506804,1689506817,13,6920,Delta Air Lines,ORD,MKE
DL720,1689520246,1689521600,1354,3730,Delta Air Lines,MKE,LAX
DL720,1689528377,1689532697,4320,8939,Delta Air Lines,LAX,ORD
DL720,1689550970,1689551185,215,14565,Delta Air Lines,ORD,MKE
DL720,1689575385,1689577642,2257,12247,Delta Air Lines,MKE,ORD
DL720,1689592718,1689593797,1079,14922,Delta Air Lines,ORD,MKE
DL720,1689619350,1689619898,548,18383,Delta Air Lines,MKE,LAX
DL720,1689646738,1689649810,3072,7039,Delta Air Lines,LAX,ORD
DL720,1689657783,1689657944,161,16233,Delta Air Lines,ORD,MKE
DL720,1689677989,1689678281,292,5172,Delta Air Lines,MKE,SFO
DL720,1689692859,1689694612,1753,12913,Delta Air Lines,SFO,LAX
DL720,1689707649,1689717003,9354,11429,Delta Air Lines,LAX,ORD
DL720,1689732717,1689733004,287,15795,Delta Air Lines,ORD,MKE
DL720,1689754570,1689755397,827,8631,Delta Air Lines,MKE,SFO
DL720,1689766157,1689766495,338,15000,Delta Air Lines,SFO,LAX
DL720,1689782633,1689785090,2457,16790,Delta Air Lines,LAX,ORD
DL720,1689812123,1689812151,28,15609,Delta Air Lines,ORD,MKE
DL720,1689828098,1689837024,8926,12144,Delta Air Lines,MKE,ORD
DL720,1689855855,1689856397,542,16639,Delta Air Lines,ORD,MKE
DL720,1689873996,1689875502,1506,7912,Delta Air Lines,MKE,LAX
DL720,1689886420,1689889945,3525,14716,Delta Air Lines,LAX,ORD
DL720,1689911798,1689912763,965,8616,Delta Air Lines,ORD,MKE
DL720,1689931775,1689933008,1233,10281,Delta Air Lines,MKE,SFO
DL720,1689944014,1689945483,1469,11532,Delta Air Lines,SFO,LAX
DL720,1689962034,1689967788,5754,20126,Delta Air Lines,LAX,ORD
DL720,1689988776,1689990494,1718,19936,Delta Air Lines,ORD,MKE
DL720,1690011767,1690012744,977,12846,Delta Air Lines,MKE,LAX
DL720,1690026302,1690034229,7927,9619,Delta Air Lines,LAX,ORD
DL720,1690044636,1690045587,951,20601,Delta Air Lines,ORD,MKE
DL720,1690070736,1690074855,4119,20891,Delta Air Lines,MKE,ORD
DL720,1690095971,1690096255,284,17756,Delta Air Lines,ORD,MKE
DL720,1690121938,1690122491,553,11548,Delta Air Lines,MKE,LAX
DL720,1690139375,1690141613,2238,16669,Delta Air Lines,LAX,ORD
DL720,1690167786,1690169319,1533,16067,Delta Air Lines,ORD,MKE
DL720,1690190441,1690190638,197,17362,Delta Air Lines,MKE,LAX
DL720,1690212942,1690219969,7027,19709,Delta Air Lines,LAX,ORD
DL720,1690248324,1690248433,109,6932,Delta Air Lines,ORD,MKE
DL720,1690257756,1690258207,451,17144,Delta Air Lines,MKE,SFO
DL720,1690281663,1690289090,7427,16713,Delta Air Lines,SFO,ORD
DL720,1690309389,1690309812,423,13361,Delta Air Lines,ORD,MKE
DL720,1690333450,1690334639,1189,10526,Delta Air Lines,MKE,LAX
DL720,1690353805,1690355355,1550,17331,Delta Air Lines,LAX,SFO
DL720,1690379955,1690389414,9459,19242,Delta Air Lines,SFO,ORD
DL720,1690418495,1690418850,355,14788,Delta Air Lines,ORD,MKE
DL720,1690443504,1690445199,1695,6403,Delta Air Lines,MKE,SFO
DL720,1690461636,1690462284,648,4612,Delta Air Lines,SFO,LAX
DL720,1690473036,1690475504,2468,11739,Delta Air Lines,LAX,ORD
DL720,1690488862,1690488967,105,16632,Delta Air Lines,ORD,MKE
DL720,1690509095,1690509626,531,18090,Delta Air Lines,MKE,SFO
DL720,1690534164,1690534988,824,6840,Delta Air Lines,SFO,LAX
DL720,1690551252,1690551770,518,14225,Delta Air Lines,LAX,SFO
DL720,1690571698,1690581104,9406,19761,Delta Air Lines,SFO,ORD
DL720,1690608412,1690608738,326,21270,Delta Air Lines,ORD,MKE
DL720,1690633154,1690634432,1278,16998,Delta Air Lines,MKE,SFO
DL720,1690653372,1690653546,174,7430,Delta Air Lines,SFO,LAX
DL720,1690669193,1690670984,1791,7334,Delta Air Lines,LAX,SFO
DL720,1690682317,1690684664,2347,8191,Delta Air Lines,SFO,ORD
DL720,1690700192,1690701300,1108,8593,Delta Air Lines,ORD,MKE
DL720,1690712046,1690717949,5903,12930,Delta Air Lines,MKE,ORD
DL720,1690732838,1690734044,1206,4611,Delta Air Lines,ORD,MKE
DL720,1690739188,1690745442,6254,13025,Delta Air Lines,MKE,ORD
DL720,1690769204,1690770836,1632,17350,Delta Air Lines,ORD,MKE
DL720,1690788723,1690789067,344,7751,Delta Air Lines,MKE,SFO
DL720,1690806024,1690806564,540,4383,Delta Air Lines,SFO,LAX
DL720,1690819497,1690820613,1116,18611,Delta Air Lines,LAX,SFO
DL720,1690849985,1690858314,8329,17525,Delta Air Lines,SFO,ORD
DL720,1690880381,1690880941,560,14898,Delta Air Lines,ORD,MKE
DL720,1690902915,1690903117,202,13712,Delta Air Lines,MKE,SFO
DL720,1690919755,1690921340,1585,17277,Delta Air Lines,SFO,LAX
DL720,1690948069,1690948145,76,14531,Delta Air Lines,LAX,SFO
DL720,1690964031,1690974629,10598,10578,Delta Air Lines,SFO,ORD
DL720,1690991218,1690992683,1465,12057,Delta Air Lines,ORD,MKE
DL720,1691014156,1691015638,1482,19089,Delta Air Lines,MKE,LAX
DL720,1691040902,1691041788,886,14745,Delta Air Lines,LAX,SFO
DL720,1691061286,1691069125,7839,13312,Delta Air Lines,SFO,ORD
DL720,1691082672,1691082727,55,14424,Delta Air Lines,ORD,MKE
DL720,1691101195,1691104944,3749,3993,Delta Air Lines,MKE,ORD
DL720,1691115377,1691116270,893,10106,Delta Air Lines,ORD,MKE
DL720,1691128627,1691128942,315,14886,Delta Air Lines,MKE,SFO
DL720,1691144017,1691145319,1302,5290,Delta Air Lines,SFO,LAX
DL720,1691152868,1691154573,1705,14662,Delta Air Lines,LAX,SFO
DL720,1691172340,1691177693,5353,13907,Delta Air Lines,SFO,ORD
DL720,1691193557,1691194859,1302,16534,Delta Air Lines,ORD,MKE
DL720,1691212807,1691213547,740,4960,Delta Air Lines,MKE,LAX
DL720,1691228459,1691228900,441,6192,Delta Air Lines,LAX,SFO
DL720,1691237829,1691248352,10523,14368,Delta Air Lines,SFO,ORD
DL720,1691267902,1691268151,249,14876,Delta Air Lines,ORD,MKE
DL720,1691289062,1691294727,5665,18808,Delta Air Lines,MKE,ORD
DL720,1691320707,1691321659,952,7292,Delta Air Lines,ORD,MKE
DL720,1691333168,1691335787,2619,6160,Delta Air Lines,MKE,ORD
DL720,1691343471,1691344503,1032,3786,Delta Air Lines,ORD,MKE
DL720,1691356199,1691360528,4329,8425,Delta Air Lines,MKE,ORD
DL720,1691369111,1691370572,1461,18458,Delta Air Lines,ORD,MKE
DL720,1691398200,1691398330,130,4348,Delta Air Lines,MKE,SFO
DL720,1691408232,1691409543,1311,15873,Delta Air Lines,SFO,LAX
DL720,1691434499,1691445122,10623,19952,Delta Air Lines,LAX,ORD
DL720,1691470434,1691470728,294,10128,Delta Air Lines,ORD,MKE
DL720,1691490764,1691498283,7519,12915,Delta Air Lines,MKE,ORD
DL720,1691519472,1691520942,1470,20590,Delta Air Lines,ORD,MKE
DL720,1691544718,1691545385,667,7318,Delta Air Lines,MKE,SFO
DL720,1691553865,1691559347,5482,15690,Delta Air Lines,SFO,ORD
DL720,1691580723,1691582380,1657,21176,Delta Air Lines,ORD,MKE
DL720,1691613599,1691614893,1294,10766,Delta Air Lines,MKE,LAX
DL720,1691625925,1691635511,9586,15828,Delta Air Lines,LAX,ORD
DL720,1691657675,1691658473,798,15428,Delta Air Lines,ORD,MKE
DL720,1691678524,1691679911,1387,14897,Delta Air Lines,MKE,SFO
DL720,1691700660,1691701108,448,8279,Delta Air Lines,SFO,LAX
DL720,1691716258,1691716755,497,9305,Delta Air Lines,LAX,SFO
DL720,1691734398,1691740855,6457,9583,Delta Air Lines,SFO,ORD
DL720,1691754680,1691755812,1132,6178,Delta Air Lines,ORD,MKE
DL720,1691770799,1691779574,8775,4085,Delta Air Lines,MKE,ORD
DL720,1691786368,1691788143,1775,12818,Delta Air Lines,ORD,MKE
DL720,1691806279,1691810370,4091,10709,Delta Air Lines,MKE,ORD
DL720,1691822096,1691822475,379,14759,Delta Air Lines,ORD,MKE
DL720,1691843311,1691851377,8066,8762,Delta Air Lines,MKE,ORD
DL720,1691870420,1691870654,234,14969,Delta Air Lines,ORD,MKE
DL720,1691894511,1691898532,4021,11353,Delta Air Lines,MKE,ORD
DL720,1691915403,1691915742,339,8559,Delta Air Lines,ORD,MKE
DL720,1691934346,1691934488,142,18260,Delta Air Lines,MKE,LAX
DL720,1691953688,1691954854,1166,16713,Delta Air Lines,LAX,SFO
DL720,1691979960,1691980820,860,15465,Delta Air Lines,SFO,LAX
DL720,1692005368,1692005651,283,19576,Delta Air Lines,LAX,SFO
DL720,1692027332,1692032286,4954,11154,Delta Air Lines,SFO,ORD
DL720,1692045414,1692046771,1357,21037,Delta Air Lines,ORD,MKE
DL720,1692071789,1692072915,1126,18144,Delta Air Lines,MKE,LAX
DL720,1692093801,1692098474,4673,5101,Delta Air Lines,LAX,ORD
DL720,1692104242,1692104663,421,7716,Delta Air Lines,ORD,MKE
DL720,1692122991,1692124575,1584,3791,Delta Air Lines,MKE,SFO
DL720,1692134285,1692135853,1568,16688,Delta Air Lines,SFO,LAX
DL720,1692162709,1692167792,5083,16969,Delta Air Lines,LAX,ORD
DL720,1692187680,1692188621,941,17875,Delta Air Lines,ORD,MKE
DL720,1692212786,1692213599,813,7421,Delta Air Lines,MKE,SFO
DL720,1692227282,1692231960,4678,20932,Delta Air Lines,SFO,ORD
DL720,1692261540,1692261858,318,11142,Delta Air Lines,ORD,MKE
DL720,1692276744,1692285624,8880,16102,Delta Air Lines,MKE,ORD
DL720,1692310873,1692310968,95,12865,Delta Air Lines,ORD,MKE
DL720,1692333830,1692334743,913,21010,Delta Air Lines,MKE,LAX
DL720,1692358775,1692360256,1481,20473,Delta Air Lines,LAX,SFO
DL720,1692385577,1692391737,6160,13045,Delta Air Lines,SFO,ORD
DL720,1692408744,1692409571,827,18450,Delta Air Lines,ORD,MKE
DL720,1692435180,1692440980,5800,10734,Delta Air Lines,MKE,ORD
DL720,1692462401,1692464178,1777,11230,Delta Air Lines,ORD,MKE
DL720,1692477153,1692483051,5898,6748,Delta Air Lines,MKE,ORD
DL720,1692493171,1692494757,1586,7533,Delta Air Lines,ORD,MKE
DL720,1692511759,1692512821,1062,5489,Delta Air Lines,MKE,SFO
DL720,1692521303,1692524959,3656,7773,Delta Air Lines,SFO,ORD
DL720,1692540651,1692541354,703,17890,Delta Air Lines,ORD,MKE
DL720,1692562500,1692569476,6976,16155,Delta Air Lines,MKE,ORD
DL720,1692593468,1692594986,1518,11021,Delta Air Lines,ORD,MKE
DL720,1692606573,1692607916,1343,19343,Delta Air Lines,MKE,SFO
DL720,1692633693,1692638489,4796,20856,Delta Air Lines,SFO,ORD
DL720,1692661863,1692662204,341,19287,Delta Air Lines,ORD,MKE
DL720,1692685388,1692686591,1203,6334,Delta Air Lines,MKE,LAX
DL720,1692703348,1692703715,367,19769,Delta Air Lines,LAX,SFO
DL720,1692733729,1692734291,562,8465,Delta Air Lines,SFO,LAX
DL720,1692752248,1692753010,762,12993,Delta Air Lines,LAX,SFO
DL720,1692768875,1692769502,627,12394,Delta Air Lines,SFO,LAX
DL720,1692783408,1692785066,1658,16244,Delta Air Lines,LAX,SFO
DL720,1692807181,1692812157,4976,12588,Delta Air Lines,SFO,ORD
DL720,1692828032,1692829510,1478,12172,Delta Air Lines,ORD,MKE
DL720,1692850389,1692858359,7970,11276,Delta Air Lines,MKE,ORD
DL720,1692874478,1692875545,1067,11915,Delta Air Lines,ORD,MKE
DL720,1692890560,1692892490,1930,19371,Delta Air Lines,MKE,ORD
DL720,1692915023,1692915814,791,5481,Delta Air Lines,ORD,MKE
DL720,1692923005,1692924215,1210,15192,Delta Air Lines,MKE,LAX
DL720,1692939639,1692948367,8728,10004,Delta Air Lines,LAX,ORD
DL720,1692967953,1692969133,1180,16311,Delta Air Lines,ORD,MKE
DL720,1692992699,1692994247,1548,9221,Delta Air Lines,MKE,SFO
DL720,1693004114,1693004492,378,11266,Delta Air Lines,SFO,LAX
DL720,1693025647,1693027466,1819,19873,Delta Air Lines,LAX,ORD
DL720,1693055982,1693056224,242,12195,Delta Air Lines,ORD,MKE
DL720,1693071949,1693073193,1244,16440,Delta Air Lines,MKE,LAX
DL720,1693100078,1693102591,2513,10003,Delta Air Lines,LAX,ORD
DL720,1693117609,1693119004,1395,18397,Delta Air Lines,ORD,MKE
DL720,1693147767,1693149385,1618,10934,Delta Air Lines,MKE,SFO
DL720,1693162887,1693164447,1560,16721,Delta Air Lines,SFO,LAX
DL720,1693182014,1693185113,3099,11937,Delta Air Lines,LAX,ORD
DL720,1693197989,1693198040,51,11795,Delta Air Lines,ORD,MKE
DL720,1693215050,1693215895,845,7540,Delta Air Lines,MKE,SFO
DL720,1693225652,1693226510,858,11343,Delta Air Lines,SFO,LAX
DL720,1693240977,1693247892,6915,17512,Delta Air Lines,LAX,ORD
DL720,1693273047,1693273353,306,18562,Delta Air Lines,ORD,MKE
DL720,1693295209,1693296977,1768,17522,Delta Air Lines,MKE,LAX
DL720,1693320446,1693328277,7831,9923,Delta Air Lines,LAX,ORD
DL720,1693348822,1693348894,72,10249,Delta Air Lines,ORD,MKE
DL720,1693360646,1693362350,1704,3763,Delta Air Lines,MKE,LAX
DL720,1693373328,1693376928,3600,17684,Delta Air Lines,LAX,ORD
DL720,1693397640,1693399219,1579,11004,Delta Air Lines,ORD,MKE
DL720,1693413466,1693414994,1528,17097,Delta Air Lines,MKE,LAX
DL720,1693440192,1693447809,7617,8255,Delta Air Lines,LAX,ORD
DL720,1693460363,1693462121,1758,12294,Delta Air Lines,ORD,MKE
DL720,1693480652,1693482191,1539,7235,Delta Air Lines,MKE,LAX
DL720,1693495893,1693497413,1520,15940,Delta Air Lines,LAX,SFO
DL720,1693522681,1693530804,8123,7324,Delta Air Lines,SFO,ORD
DL720,1693539148,1693540296,1148,9149,Delta Air Lines,ORD,MKE
DL720,1693558809,1693559281,472,15103,Delta Air Lines,MKE,LAX
DL720,1693578195,1693583725,5530,20736,Delta Air Lines,LAX,ORD
DL720,1693611177,1693612212,1035,6168,Delta Air Lines,ORD,MKE
DL720,1693622831,1693627837,5006,19099,Delta Air Lines,MKE,ORD
DL720,1693657310,1693657425,115,11518,Delta Air Lines,ORD,MKE
DL720,1693674873,1693679190,4317,19794,Delta Air Lines,MKE,ORD
DL720,1693704245,1693705264,1019,3710,Delta Air Lines,ORD,MKE
DL720,1693709708,1693715297,5589,6909,Delta Air Lines,MKE,ORD
DL720,1693724710,1693726214,1504,13980,Delta Air Lines,ORD,MKE
DL720,1693746680,1693747474,794,19302,Delta Air Lines,MKE,SFO
DL720,1693776953,1693777253,300,17528,Delta Air Lines,SFO,LAX
DL720,1693798071,1693807035,8964,18009,Delta Air Lines,LAX,ORD
DL720,1693828684,1693829123,439,10355,Delta Air Lines,ORD,MKE
DL720,1693840993,1693848300,7307,5093,Delta Air Lines,MKE,ORD
DL720,1693864083,1693864889,806,20740,Delta Air Lines,ORD,MKE
DL720,1693891561,1693899701,8140,4086,Delta Air Lines,MKE,ORD
DL720,1693907653,1693907853,200,11521,Delta Air Lines,ORD,MKE
DL720,1693927389,1693927852,463,4042,Delta Air Lines,MKE,SFO
DL720,1693939742,1693946435,6693,6014,Delta Air Lines,SFO,ORD
DL720,1693959106,1693960796,1690,18848,Delta Air Lines,ORD,MKE
DL720,1693980637,1693980907,270,9805,Delta Air Lines,MKE,LAX
DL720,1693992620,1693999625,7005,6803,Delta Air Lines,LAX,ORD
DL720,1694016306,1694016549,243,8608,Delta Air Lines,ORD,MKE
DL720,1694033066,1694033816,750,15671,Delta Air Lines,MKE,LAX
DL720,1694055928,1694056620,692,3944,Delta Air Lines,LAX,SFO
DL720,1694060895,1694063168,2273,18070,Delta Air Lines,SFO,ORD
DL720,1694086711,1694086713,2,4127,Delta Air Lines,ORD,MKE
DL720,1694092423,1694096632,4209,5601,Delta Air Lines,MKE,ORD
DL720,1694104067,1694105228,1161,14737,Delta Air Lines,ORD,MKE
DL720,1694125983,1694126871,888,15831,Delta Air Lines,MKE,LAX
DL720,1694144668,1694150889,6221,5517,Delta Air Lines,LAX,ORD
DL720,1694162961,1694164072,1111,7846,Delta Air Lines,ORD,MKE
DL720,1694177411,1694179105,1694,19313,Delta Air Lines,MKE,SFO
DL720,1694204590,1694207816,3226,17593,Delta Air Lines,SFO,ORD
DL720,1694234949,1694236696,1747,6531,Delta Air Lines,ORD,MKE
DL720,1694247485,1694248924,1439,19795,Delta Air Lines,MKE,SFO
DL720,1694270391,1694279208,8817,21041,Delta Air Lines,SFO,ORD
DL720,1694306006,1694306656,650,12140,Delta Air Lines,ORD,MKE
DL720,1694319936,1694320366,430,16333,Delta Air Lines,MKE,LAX
DL720,1694339503,1694340949,1446,21358,Delta Air Lines,LAX,SFO
DL720,1694362780,1694364369,1589,11814,Delta Air Lines,SFO,LAX
DL720,1694376485,1694386184,9699,16714,Delta Air Lines,LAX,ORD
DL720,1694403241,1694403770,529,19828,Delta Air Lines,ORD,MKE
DL720,1694430480,1694431395,915,4924,Delta Air Lines,MKE,SFO
DL720,1694443806,1694444839,1033,16724,Delta Air Lines,SFO,LAX
DL720,1694469502,1694477402,7900,19771,Delta Air Lines,LAX,ORD
DL720,1694500940,1694501546,606,7779,Delta Air Lines,ORD,MKE
DL720,1694512397,1694513232,835,17727,Delta Air Lines,MKE,LAX
DL720,1694538978,1694543479,4501,4784,Delta Air Lines,LAX,ORD
DL720,1694555118,1694556409,1291,20835,Delta Air Lines,ORD,MKE
DL720,1694580773,1694580881,108,15957,Delta Air Lines,MKE,SFO
DL720,1694600154,1694600687,533,10803,Delta Air Lines,SFO,LAX
DL720,1694615625,1694616452,827,8758,Delta Air Lines,LAX,SFO
DL720,1694633693,1694634277,584,10871,Delta Air Lines,SFO,LAX
DL720,1694653658,1694659994,6336,12231,Delta Air Lines,LAX,ORD
DL720,1694672776,1694673622,846,12997,Delta Air Lines,ORD,MKE
DL720,1694688561,1694689142,581,16886,Delta Air Lines,MKE,SFO
DL720,1694712229,1694715772,3543,7946,Delta Air Lines,SFO,ORD
DL720,1694729822,1694730917,1095,13194,Delta Air Lines,ORD,MKE
DL720,1694745918,1694746130,212,9652,Delta Air Lines,MKE,LAX
DL720,1694761295,1694762947,1652,15201,Delta Air Lines,LAX,SFO
DL720,1694787632,1694788298,666,11761,Delta Air Lines,SFO,LAX
DL720,1694807269,1694811491,4222,8648,Delta Air Lines,LAX,ORD
DL720,1694821181,1694822483,1302,15185,Delta Air Lines,ORD,MKE
DL720,1694838904,1694839315,411,21259,Delta Air Lines,MKE,LAX
DL720,1694862385,1694869862,7477,3799,Delta Air Lines,LAX,ORD
DL720,1694883782,1694884889,1107,14667,Delta Air Lines,ORD,MKE
DL720,1694909583,1694911274,1691,10003,Delta Air Lines,MKE,LAX
DL720,1694931527,1694932878,1351,20074,Delta Air Lines,LAX,SFO
DL720,1694956393,1694963971,7578,9668,Delta Air Lines,SFO,ORD
DL720,1694981197,1694982543,1346,10779,Delta Air Lines,ORD,MKE
DL720,1694995763,1694999730,3967,14072,Delta Air Lines,MKE,ORD
DL720,1695023215,1695023385,170,14276,Delta Air Lines,ORD,MKE
DL720,1695040853,1695041259,406,4050,Delta Air Lines,MKE,LAX
DL720,1695051535,1695060114,8579,8420,Delta Air Lines,LAX,ORD
DL720,1695075142,1695075951,809,20195,Delta Air Lines,ORD,MKE
DL720,1695103695,1695110316,6621,11480,Delta Air Lines,MKE,ORD
DL720,1695128760,1695129860,1100,5041,Delta Air Lines,ORD,MKE
DL720,1695144032,1695144987,955,4682,Delta Air Lines,MKE,LAX
DL720,1695156213,1695156846,633,11459,Delta Air Lines,LAX,SFO
DL720,1695175458,1695181635,6177,18383,Delta Air Lines,SFO,ORD
DL720,1695207586,1695209255,1669,20126,Delta Air Lines,ORD,MKE
DL720,1695233639,1695235219,1580,10782,Delta Air Lines,MKE,SFO
DL720,1695256429,1695259020,2591,14667,Delta Air Lines,SFO,ORD
DL720,1695278235,1695278913,678,7888,Delta Air Lines,ORD,MKE
DL720,1695291950,1695298888,6938,17902,Delta Air Lines,MKE,ORD
DL720,1695325849,1695327406,1557,10928,Delta Air Lines,ORD,MKE
DL720,1695343796,1695345570,1774,6084,Delta Air Lines,MKE,SFO
DL720,1695360958,1695364473,3515,15780,Delta Air Lines,SFO,ORD
DL720,1695386673,1695387022,349,14505,Delta Air Lines,ORD,MKE
DL720,1695404759,1695410058,5299,10213,Delta Air Lines,MKE,ORD
DL720,1695422488,1695423042,554,13419,Delta Air Lines,ORD,MKE
DL720,1695436944,1695437168,224,18553,Delta Air Lines,MKE,LAX
DL720,1695456581,1695464564,7983,5697,Delta Air Lines,LAX,ORD
DL720,1695476056,1695477545,1489,9683,Delta Air Lines,ORD,MKE
DL720,1695487327,1695491035,3708,21588,Delta Air Lines,MKE,ORD
DL720,1695513011,1695514300,1289,11292,Delta Air Lines,ORD,MKE
DL720,1695529567,1695531086,1519,13686,Delta Air Lines,MKE,SFO
DL720,1695551262,1695551983,721,19360,Delta Air Lines,SFO,LAX
DL720,1695578662,1695579988,1326,5445,Delta Air Lines,LAX,SFO
DL720,1695586938,1695588202,1264,7019,Delta Air Lines,SFO,LAX
DL720,1695600660,1695601146,486,7000,Delta Air Lines,LAX,SFO
DL720,1695612034,1695613676,1642,21037,Delta Air Lines,SFO,LAX
DL720,1695637263,1695638851,1588,7906,Delta Air Lines,LAX,SFO
DL720,1695648017,1695657266,9249,5159,Delta Air Lines,SFO,ORD
DL720,1695667656,1695669306,1650,13237,Delta Air Lines,ORD,MKE
DL720,1695687198,1695687206,8,9945,Delta Air Lines,MKE,LAX
DL720,1695702122,1695711345,9223,11939,Delta Air Lines,LAX,ORD
DL720,1695731366,1695732128,762,12526,Delta Air Lines,ORD,MKE
DL720,1695752325,1695757652,5327,15132,Delta Air Lines,MKE,ORD
DL720,1695777658,1695778216,558,20975,Delta Air Lines,ORD,MKE
DL720,1695802997,1695804295,1298,18921,Delta Air Lines,MKE,SFO
DL720,1695825539,1695827152,1613,13191,Delta Air Lines,SFO,LAX
DL720,1695849680,1695852217,2537,15705,Delta Air Lines,LAX,ORD
DL720,1695873077,1695873999,922,10003,Delta Air Lines,ORD,MKE
DL720,1695886982,1695889319,2337,9086,Delta Air Lines,MKE,ORD
DL720,1695906706,1695906802,96,19316,Delta Air Lines,ORD,MKE
DL720,1695928823,1695929041,218,5565,Delta Air Lines,MKE,SFO
DL720,1695935779,1695946037,10258,21240,Delta Air Lines,SFO,ORD
DL720,1695973623,1695975055,1432,16611,Delta Air Lines,ORD,MKE
DL720,1695996455,1696006223,9768,20385,Delta Air Lines,MKE,ORD
DL720,1696029391,1696029479,88,14458,Delta Air Lines,ORD,MKE
DL720,1696050705,1696054728,4023,20677,Delta Air Lines,MKE,ORD
DL720,1696077161,1696077427,266,10321,Delta Air Lines,ORD,MKE
DL720,1696092887,1696103412,10525,15144,Delta Air Lines,MKE,ORD
DL720,1696126316,1696127400,1084,12479,Delta Air Lines,ORD,MKE
DL720,1696140471,1696140798,327,5657,Delta Air Lines,MKE,LAX
DL720,1696150463,1696157937,7474,12741,Delta Air Lines,LAX,ORD
DL720,1696176563,1696177196,633,12194,Delta Air Lines,ORD,MKE
DL720,1696199159,1696199951,792,8351,Delta Air Lines,MKE,LAX
DL720,1696214616,1696224254,9638,13801,Delta Air Lines,LAX,ORD
DL720,1696238938,1696240434,1496,11715,Delta Air Lines,ORD,MKE
DL720,1696259648,1696267823,8175,13379,Delta Air Lines,MKE,ORD
DL720,1696282969,1696284678,1709,9167,Delta Air Lines,ORD,MKE
DL720,1696304110,1696310235,6125,8687,Delta Air Lines,MKE,ORD
DL720,1696327844,1696328722,878,20105,Delta Air Lines,ORD,MKE
DL720,1696349328,1696350826,1498,14813,Delta Air Lines,MKE,LAX
DL720,1696374519,1696375360,841,21220,Delta Air Lines,LAX,SFO
DL720,1696398759,1696399823,1064,14676,Delta Air Lines,SFO,LAX
DL720,1696420025,1696420894,869,8250,Delta Air Lines,LAX,SFO
DL720,1696439001,1696445643,6642,11061,Delta Air Lines,SFO,ORD
DL720,1696466188,1696466898,710,6926,Delta Air Lines,ORD,MKE
DL720,1696478741,1696480107,1366,7377,Delta Air Lines,MKE,SFO
DL720,1696495849,1696505187,9338,8543,Delta Air Lines,SFO,ORD
DL720,1696519261,1696519699,438,14798,Delta Air Lines,ORD,MKE
DL720,1696542305,1696543736,1431,7877,Delta Air Lines,MKE,SFO
DL720,1696562134,1696570835,8701,13242,Delta Air Lines,SFO,ORD
DL720,1696588118,1696589260,1142,20188,Delta Air Lines,ORD,MKE
DL720,1696619588,1696620661,1073,15041,Delta Air Lines,MKE,LAX
DL720,1696638498,1696638848,350,3999,Delta Air Lines,LAX,SFO
DL720,1696647474,1696648295,821,8372,Delta Air Lines,SFO,LAX
DL720,1696666850,1696667229,379,12310,Delta Air Lines,LAX,SFO
DL720,1696685760,1696688975,3215,13570,Delta Air Lines,SFO,ORD
DL720,1696710872,1696710884,12,14611,Delta Air Lines,ORD,MKE
DL720,1696729026,1696730147,1121,19627,Delta Air Lines,MKE,SFO
DL720,1696750227,1696750461,234,19847,Delta Air Lines,SFO,LAX
DL720,1696777433,1696779390,1957,20381,Delta Air Lines,LAX,ORD
DL720,1696801253,1696802506,1253,13370,Delta Air Lines,ORD,MKE
DL720,1696823297,1696824754,1457,7606,Delta Air Lines,MKE,LAX
DL720,1696840886,1696848259,7373,21234,Delta Air Lines,LAX,ORD
DL720,1696874838,1696875193,355,8202,Delta Air Lines,ORD,MKE
DL720,1696892037,1696902099,10062,9807,Delta Air Lines,MKE,ORD
DL720,1696916379,1696917433,1054,6542,Delta Air Lines,ORD,MKE
DL720,1696924735,1696934513,9778,6539,Delta Air Lines,MKE,ORD
DL720,1696947494,1696948491,997,15510,Delta Air Lines,ORD,MKE
DL720,1696971397,1696972291,894,8773,Delta Air Lines,MKE,SFO
DL720,1696989068,1696997625,8557,7865,Delta Air Lines,SFO,ORD
DL720,1697006696,1697008023,1327,13905,Delta Air Lines,ORD,MKE
DL720,1697023733,1697023756,23,15317,Delta Air Lines,MKE,LAX
DL720,1697042473,1697053190,10717,9431,Delta Air Lines,LAX,ORD
DL720,1697068350,1697068553,203,14658,Delta Air Lines,ORD,MKE
DL720,1697093012,1697096963,3951,8474,Delta Air Lines,MKE,ORD
DL720,1697107755,1697108991,1236,14593,Delta Air Lines,ORD,MKE
DL720,1697131704,1697134053,2349,14214,Delta Air Lines,MKE,ORD
DL720,1697158992,1697159046,54,20877,Delta Air Lines,ORD,MKE
DL720,1697186295,1697187837,1542,9153,Delta Air Lines,MKE,SFO
DL720,1697207126,1697210510,3384,14756,Delta Air Lines,SFO,ORD
DL720,1697235423,1697236460,1037,14142,Delta Air Lines,ORD,MKE
DL720,1697251848,1697257385,5537,4075,Delta Air Lines,MKE,ORD
DL720,1697265472,1697265644,172,6809,Delta Air Lines,ORD,MKE
DL720,1697280535,1697281322,787,6924,Delta Air Lines,MKE,SFO
DL720,1697291119,1697297518,6399,19851,Delta Air Lines,SFO,ORD
DL720,1697320008,1697321535,1527,15209,Delta Air Lines,ORD,MKE
DL720,1697340328,1697344223,3895,20124,Delta Air Lines,MKE,ORD
DL720,1697372539,1697372821,282,12766,Delta Air Lines,ORD,MKE
DL720,1697391415,1697391525,110,3669,Delta Air Lines,MKE,SFO
DL720,1697402766,1697404590,1824,20609,Delta Air Lines,SFO,ORD
DL720,1697432975,1697433959,984,5675,Delta Air Lines,ORD,MKE
DL720,1697443158,1697448489,5331,12193,Delta Air Lines,MKE,ORD
DL720,1697460927,1697462374,1447,4541,Delta Air Lines,ORD,MKE
DL720,1697469467,1697469547,80,5332,Delta Air Lines,MKE,SFO
DL720,1697479842,1697488429,8587,10178,Delta Air Lines,SFO,ORD
DL720,1697500012,1697501163,1151,11340,Delta Air Lines,ORD,MKE
DL720,1697522773,1697523897,1124,17167,Delta Air Lines,MKE,SFO
DL720,1697551019,1697551874,855,15125,Delta Air Lines,SFO,LAX
DL720,1697570966,1697571737,771,21052,Delta Air Lines,LAX,SFO
DL720,1697601998,1697603279,1281,18613,Delta Air Lines,SFO,LAX
DL720,1697630238,1697631730,1492,7203,Delta Air Lines,LAX,SFO
DL720,1697648107,1697649447,1340,4192,Delta Air Lines,SFO,LAX
DL720,1697656051,1697658485,2434,4847,Delta Air Lines,LAX,ORD
DL720,1697664948,1697666596,1648,12429,Delta Air Lines,ORD,MKE
DL720,1697689808,1697691045,1237,12993,Delta Air Lines,MKE,LAX
DL720,1697710515,1697712119,1604,17038,Delta Air Lines,LAX,SFO
DL720,1697738405,1697746588,8183,20854,Delta Air Lines,SFO,ORD
DL720,1697774602,1697775832,1230,5129,Delta Air Lines,ORD,MKE
DL720,1697783516,1697786244,2728,13477,Delta Air Lines,MKE,ORD
DL720,1697810258,1697811901,1643,15466,Delta Air Lines,ORD,MKE
DL720,1697834092,1697834663,571,15324,Delta Air Lines,MKE,SFO
DL720,1697859777,1697867582,7805,14144,Delta Air Lines,SFO,ORD
DL720,1697889116,1697889330,214,6048,Delta Air Lines,ORD,MKE
DL720,1697904823,1697904879,56,12500,Delta Air Lines,MKE,SFO
DL720,1697926869,1697936451,9582,17912,Delta Air Lines,SFO,ORD
DL720,1697958620,1697959725,1105,17681,Delta Air Lines,ORD,MKE
DL720,1697984210,1697990594,6384,17555,Delta Air Lines,MKE,ORD
DL720,1698008236,1698008320,84,4408,Delta Air Lines,ORD,MKE
DL720,1698020583,1698031118,10535,9050,Delta Air Lines,MKE,ORD
DL720,1698046489,1698047944,1455,17067,Delta Air Lines,ORD,MKE
DL720,1698071432,1698072336,904,15605,Delta Air Lines,MKE,SFO
DL720,1698091359,1698093198,1839,7552,Delta Air Lines,SFO,ORD
DL720,1698111253,1698111636,383,9043,Delta Air Lines,ORD,MKE
DL720,1698122846,1698124226,1380,6000,Delta Air Lines,MKE,SFO
DL720,1698137786,1698141330,3544,12316,Delta Air Lines,SFO,ORD
DL720,1698163918,1698165497,1579,4902,Delta Air Lines,ORD,MKE
DL720,1698177568,1698177724,156,17883,Delta Air Lines,MKE,SFO
DL720,1698204812,1698206422,1610,9467,Delta Air Lines,SFO,LAX
DL720,1698225741,1698228730,2989,13719,Delta Air Lines,LAX,ORD
DL720,1698247775,1698248579,804,4887,Delta Air Lines,ORD,MKE
DL720,1698262513,1698264898,2385,5084,Delta Air Lines,MKE,ORD
DL720,1698272907,1698273647,740,21076,Delta Air Lines,ORD,MKE
DL720,1698297095,1698298633,1538,19801,Delta Air Lines,MKE,LAX
DL720,1698319857,1698321450,1593,20674,Delta Air Lines,LAX,SFO
DL720,1698347239,1698348032,793,6293,Delta Air Lines,SFO,LAX
DL720,1698354599,1698362850,8251,20265,Delta Air Lines,LAX,ORD
DL720,1698392384,1698393853,1469,10823,Delta Air Lines,ORD,MKE
DL720,1698409798,1698409885,87,9362,Delta Air Lines,MKE,LAX
DL720,1698420640,1698421226,586,8718,Delta Air Lines,LAX,SFO
DL720,1698440606,1698442356,1750,20296,Delta Air Lines,SFO,LAX
DL720,1698464939,1698473261,8322,15389,Delta Air Lines,LAX,ORD
DL720,1698491938,1698492411,473,6305,Delta Air Lines,ORD,MKE
AA214,1682959659,1682960097,438,9658,American Airlines,LAX,SFO
AA214,1682972886,1682982303,9417,6657,American Airlines,SFO,ORD
AA214,1682999406,1683000647,1241,5403,American Airlines,ORD,MKE
AA214,1683008454,1683008911,457,18799,American Airlines,MKE,LAX
AA214,1683035735,1683045236,9501,6662,American Airlines,LAX,ORD
AA214,1683055127,1683056006,879,8566,American Airlines,ORD,MKE
AA214,1683065479,1683065637,158,10553,American Airlines,MKE,SFO
AA214,1683082304,1683082984,680,7109,American Airlines,SFO,LAX
AA214,1683095934,1683104318,8384,18491,American Airlines,LAX,ORD
AA214,1683132099,1683132170,71,8225,American Airlines,ORD,MKE
AA214,1683148122,1683149252,1130,12431,American Airlines,MKE,LAX
AA214,1683163318,1683163488,170,20055,American Airlines,LAX,SFO
AA214,1683186879,1683187626,747,7033,American Airlines,SFO,LAX
AA214,1683201713,1683202326,613,12795,American Airlines,LAX,SFO
AA214,1683217759,1683225973,8214,3708,American Airlines,SFO,ORD
AA214,1683231558,1683231937,379,19966,American Airlines,ORD,MKE
AA214,1683258771,1683260021,1250,13003,American Airlines,MKE,SFO
AA214,1683275627,1683276532,905,4179,American Airlines,SFO,LAX
AA214,1683287138,1683292131,4993,17950,American Airlines,LAX,ORD
AA214,1683318826,1683319042,216,10309,American Airlines,ORD,MKE
AA214,1683339714,1683341105,1391,14769,American Airlines,MKE,LAX
AA214,1683358686,1683359979,1293,16832,American Airlines,LAX,SFO
AA214,1683382158,1683383487,1329,15387,American Airlines,SFO,LAX
AA214,1683400711,1683401430,719,17284,American Airlines,LAX,SFO
AA214,1683419664,1683421458,1794,21533,American Airlines,SFO,LAX
AA214,1683443550,1683444013,463,5706,American Airlines,LAX,SFO
AA214,1683450427,1683452209,1782,20089,American Airlines,SFO,LAX
AA214,1683481070,1683482784,1714,13247,American Airlines,LAX,SFO
AA214,1683497309,1683507208,9899,7844,American Airlines,SFO,ORD
AA214,1683524517,1683525899,1382,14031,American Airlines,ORD,MKE
AA214,1683548588,1683548774,186,5736,American Airlines,MKE,SFO
AA214,1683561697,1683564558,2861,6082,American Airlines,SFO,ORD
AA214,1683572097,1683573004,907,12786,American Airlines,ORD,MKE
AA214,1683590781,1683594228,3447,13617,American Airlines,MKE,ORD
AA214,1683607936,1683608445,509,7623,American Airlines,ORD,MKE
AA214,1683626036,1683628990,2954,20113,American Airlines,MKE,ORD
AA214,1683658280,1683659247,967,16677,American Airlines,ORD,MKE
AA214,1683676161,1683683923,7762,20966,American Airlines,MKE,ORD
AA214,1683715081,1683716479,1398,16945,American Airlines,ORD,MKE
AA214,1683740263,1683740408,145,17633,American Airlines,MKE,SFO
AA214,1683765552,1683767108,1556,20451,American Airlines,SFO,LAX
AA214,1683798079,1683798422,343,13267,American Airlines,LAX,SFO
AA214,1683814105,1683815637,1532,18164,American Airlines,SFO,LAX
AA214,1683843783,1683844137,354,12603,American Airlines,LAX,SFO
AA214,1683861862,1683870982,9120,19653,American Airlines,SFO,ORD
AA214,1683892540,1683893669,1129,16765,American Airlines,ORD,MKE
AA214,1683911336,1683913074,1738,12452,American Airlines,MKE,LAX
AA214,1683931629,1683935255,3626,19720,American Airlines,LAX,ORD
AA214,1683961802,1683963235,1433,3601,American Airlines,ORD,MKE
AA214,1683971884,1683979734,7850,18428,American Airlines,MKE,ORD
AA214,1684006442,1684007919,1477,6118,American Airlines,ORD,MKE
AA214,1684015857,1684017211,1354,8618,American Airlines,MKE,SFO
AA214,1684035747,1684042815,7068,13317,American Airlines,SFO,ORD
AA214,1684060595,1684061305,710,14732,American Airlines,ORD,MKE
AA214,1684081444,1684089727,8283,6827,American Airlines,MKE,ORD
AA214,1684101994,1684103008,1014,3945,American Airlines,ORD,MKE
AA214,1684108630,1684109987,1357,15013,American Airlines,MKE,LAX
AA214,1684131509,1684140315,8806,5155,American Airlines,LAX,ORD
AA214,1684151733,1684152790,1057,21457,American Airlines,ORD,MKE
AA214,1684181897,1684190457,8560,14800,American Airlines,MKE,ORD
AA214,1684207465,1684208182,717,18433,American Airlines,ORD,MKE
AA214,1684229176,1684229662,486,21403,American Airlines,MKE,LAX
AA214,1684259622,1684264245,4623,5392,American Airlines,LAX,ORD
AA214,1684277922,1684278876,954,17703,American Airlines,ORD,MKE
AA214,1684303527,1684306666,3139,20858,American Airlines,MKE,ORD
AA214,1684329908,1684331622,1714,12152,American Airlines,ORD,MKE
AA214,1684351517,1684354375,2858,6949,American Airlines,MKE,ORD
AA214,1684371676,1684371812,136,13886,American Airlines,ORD,MKE
AA214,1684391150,1684392163,1013,16899,American Airlines,MKE,LAX
AA214,1684409256,1684411981,2725,10709,American Airlines,LAX,ORD
AA214,1684429362,1684430076,714,11698,American Airlines,ORD,MKE
AA214,1684448562,1684449042,480,7494,American Airlines,MKE,LAX
AA214,1684463506,1684470181,6675,13345,American Airlines,LAX,ORD
AA214,1684487394,1684487696,302,13035,American Airlines,ORD,MKE
AA214,1684501512,1684502535,1023,19235,American Airlines,MKE,SFO
AA214,1684521855,1684522252,397,14127,American Airlines,SFO,LAX
AA214,1684546614,1684551206,4592,16163,American Airlines,LAX,ORD
AA214,1684571797,1684572788,991,11304,American Airlines,ORD,MKE
AA214,1684585742,1684586587,845,6464,American Airlines,MKE,LAX
AA214,1684595129,1684595966,837,6753,American Airlines,LAX,SFO
AA214,1684605586,1684609589,4003,15621,American Airlines,SFO,ORD
AA214,1684628736,1684630515,1779,4177,American Airlines,ORD,MKE
AA214,1684637592,1684646620,9028,4263,American Airlines,MKE,ORD
AA214,1684651360,1684651502,142,14796,American Airlines,ORD,MKE
AA214,1684676009,1684676976,967,10838,American Airlines,MKE,LAX
AA214,1684694144,1684694364,220,5117,American Airlines,LAX,SFO
AA214,1684705484,1684707103,1619,15077,American Airlines,SFO,LAX
AA214,1684730293,1684731113,820,11963,American Airlines,LAX,SFO
AA214,1684753355,1684753786,431,5546,American Airlines,SFO,LAX
AA214,1684761062,1684761558,496,6012,American Airlines,LAX,SFO
AA214,1684771194,1684772568,1374,15888,American Airlines,SFO,LAX
AA214,1684790256,1684801005,10749,7828,American Airlines,LAX,ORD
AA214,1684813105,1684814311,1206,5635,American Airlines,ORD,MKE
AA214,1684824219,1684824337,118,19203,American Airlines,MKE,SFO
AA214,1684845115,1684847793,2678,9990,American Airlines,SFO,ORD
AA214,1684867844,1684868766,922,4789,American Airlines,ORD,MKE
AA214,1684882742,1684888920,6178,4197,American Airlines,MKE,ORD
AA214,1684895398,1684896510,1112,6698,American Airlines,ORD,MKE
AA214,1684912341,1684912600,259,5561,American Airlines,MKE,LAX
AA214,1684919324,1684920243,919,8069,American Airlines,LAX,SFO
AA214,1684938852,1684944443,5591,10622,American Airlines,SFO,ORD
AA214,1684957961,1684958620,659,9836,American Airlines,ORD,MKE
AA214,1684973696,1684982476,8780,6286,American Airlines,MKE,ORD
AA214,1684997837,1684998786,949,6496,American Airlines,ORD,MKE
AA214,1685010696,1685013087,2391,10539,American Airlines,MKE,ORD
AA214,1685030032,1685031310,1278,17087,American Airlines,ORD,MKE
AA214,1685056275,1685056290,15,5907,American Airlines,MKE,SFO
AA214,1685071585,1685077118,5533,13552,American Airlines,SFO,ORD
AA214,1685100694,1685101526,832,10000,American Airlines,ORD,MKE
AA214,1685115973,1685117073,1100,20950,American Airlines,MKE,LAX
AA214,1685141033,1685146671,5638,3830,American Airlines,LAX,ORD
AA214,1685151518,1685153074,1556,21192,American Airlines,ORD,MKE
AA214,1685183660,1685185416,1756,6688,American Airlines,MKE,LAX
AA214,1685198227,1685198562,335,4373,American Airlines,LAX,SFO
AA214,1685212020,1685212795,775,12135,American Airlines,SFO,LAX
AA214,1685232619,1685233052,433,21458,American Airlines,LAX,SFO
AA214,1685265122,1685265394,272,10206,American Airlines,SFO,LAX
AA214,1685276999,1685286564,9565,20836,American Airlines,LAX,ORD
AA214,1685313731,1685313889,158,5337,American Airlines,ORD,MKE
AA214,1685320648,1685321806,1158,16398,American Airlines,MKE,LAX
AA214,1685347149,1685348797,1648,18354,American Airlines,LAX,SFO
AA214,1685375669,1685379594,3925,8291,American Airlines,SFO,ORD
AA214,1685391296,1685391439,143,12526,American Airlines,ORD,MKE
AA214,1685410562,1685411260,698,3698,American Airlines,MKE,LAX
AA214,1685422537,1685422651,114,3685,American Airlines,LAX,SFO
AA214,1685426414,1685427128,714,6550,American Airlines,SFO,LAX
AA214,1685436318,1685446473,10155,7347,American Airlines,LAX,ORD
AA214,1685454657,1685456290,1633,9822,American Airlines,ORD,MKE
AA214,1685468210,1685469768,1558,8639,American Airlines,MKE,LAX
AA214,1685483459,1685493994,10535,5504,American Airlines,LAX,ORD
AA214,1685501321,1685503110,1789,12955,American Airlines,ORD,MKE
AA214,1685525031,1685534348,9317,8600,American Airlines,MKE,ORD
AA214,1685546386,1685546673,287,10877,American Airlines,ORD,MKE
AA214,1685568209,1685571947,3738,17102,American Airlines,MKE,ORD
AA214,1685594016,1685595441,1425,13742,American Airlines,ORD,MKE
AA214,1685618431,1685619169,738,16922,American Airlines,MKE,SFO
AA214,1685642809,1685643264,455,12320,American Airlines,SFO,LAX
AA214,1685661484,1685670590,9106,11183,American Airlines,LAX,ORD
AA214,1685683726,1685684977,1251,16993,American Airlines,ORD,MKE
AA214,1685712606,1685712868,262,11316,American Airlines,MKE,SFO
AA214,1685724361,1685725587,1226,6689,American Airlines,SFO,LAX
AA214,1685733725,1685734062,337,15944,American Airlines,LAX,SFO
AA214,1685756966,1685763405,6439,16790,American Airlines,SFO,ORD
AA214,1685786624,1685786784,160,11385,American Airlines,ORD,MKE
AA214,1685807620,1685816852,9232,13577,American Airlines,MKE,ORD
AA214,1685836409,1685837152,743,21361,American Airlines,ORD,MKE
AA214,1685861257,1685863041,1784,16647,American Airlines,MKE,SFO
AA214,1685886465,1685889084,2619,12691,American Airlines,SFO,ORD
AA214,1685910234,1685910616,382,3996,American Airlines,ORD,MKE
AA214,1685919933,1685919981,48,8471,American Airlines,MKE,LAX
AA214,1685933293,1685935081,1788,20529,American Airlines,LAX,SFO
AA214,1685963361,1685966811,3450,10622,American Airlines,SFO,ORD
AA214,1685981715,1685981828,113,14975,American Airlines,ORD,MKE
AA214,1685997238,1686001242,4004,9350,American Airlines,MKE,ORD
AA214,1686020120,1686020624,504,17504,American Airlines,ORD,MKE
AA214,1686048197,1686053126,4929,15087,American Airlines,MKE,ORD
AA214,1686078863,1686079750,887,12434,American Airlines,ORD,MKE
AA214,1686092239,1686093602,1363,17954,American Airlines,MKE,SFO
AA214,1686120116,1686129969,9853,11265,American Airlines,SFO,ORD
AA214,1686144719,1686146490,1771,13253,American Airlines,ORD,MKE
AA214,1686165415,1686174070,8655,20280,American Airlines,MKE,ORD
AA214,1686195692,1686196861,1169,21281,American Airlines,ORD,MKE
AA214,1686224014,1686224411,397,8979,American Airlines,MKE,LAX
AA214,1686241242,1686241860,618,14502,American Airlines,LAX,SFO
AA214,1686266122,1686267676,1554,12825,American Airlines,SFO,LAX
AA214,1686286895,1686291933,5038,11987,American Airlines,LAX,ORD
AA214,1686313294,1686314501,1207,18066,American Airlines,ORD,MKE
AA214,1686337707,1686338357,650,13130,American Airlines,MKE,SFO
AA214,1686354797,1686355374,577,20609,American Airlines,SFO,LAX
AA214,1686380122,1686380469,347,6266,American Airlines,LAX,SFO
AA214,1686388693,1686391267,2574,20006,American Airlines,SFO,ORD
AA214,1686416762,1686417692,930,11428,American Airlines,ORD,MKE
AA214,1686429866,1686431643,1777,7226,American Airlines,MKE,SFO
AA214,1686448702,1686448773,71,11360,American Airlines,SFO,LAX
AA214,1686465237,1686465253,16,6610,American Airlines,LAX,SFO
AA214,1686476982,1686485331,8349,4737,American Airlines,SFO,ORD
AA214,1686500494,1686501705,1211,10530,American Airlines,ORD,MKE
AA214,1686520203,1686520671,468,11016,American Airlines,MKE,SFO
AA214,1686532749,1686534084,1335,20332,American Airlines,SFO,LAX
AA214,1686563218,1686564836,1618,4945,American Airlines,LAX,SFO
AA214,1686578151,1686581592,3441,11557,American Airlines,SFO,ORD
AA214,1686595529,1686595669,140,19787,American Airlines,ORD,MKE
AA214,1686625441,1686635115,9674,4517,American Airlines,MKE,ORD
AA214,1686649429,1686649434,5,17369,American Airlines,ORD,MKE
AA214,1686677154,1686685374,8220,17510,American Airlines,MKE,ORD
AA214,1686703951,1686704834,883,17163,American Airlines,ORD,MKE
AA214,1686726893,1686726958,65,19056,American Airlines,MKE,LAX
AA214,1686752440,1686754158,1718,16150,American Airlines,LAX,SFO
AA214,1686779936,1686788394,8458,9526,American Airlines,SFO,ORD
AA214,1686802669,1686803200,531,12732,American Airlines,ORD,MKE
AA214,1686816407,1686818176,1769,15396,American Airlines,MKE,LAX
AA214,1686837300,1686838283,983,4495,American Airlines,LAX,SFO
AA214,1686847398,1686849076,1678,14531,American Airlines,SFO,LAX
AA214,1686869209,1686870997,1788,17381,American Airlines,LAX,SFO
AA214,1686891155,1686892839,1684,6515,American Airlines,SFO,LAX
AA214,1686899719,1686901058,1339,17092,American Airlines,LAX,SFO
AA214,1686920165,1686923885,3720,17903,American Airlines,SFO,ORD
AA214,1686950445,1686951050,605,10641,American Airlines,ORD,MKE
AA214,1686967427,1686968330,903,11720,American Airlines,MKE,SFO
AA214,1686989966,1686990959,993,6029,American Airlines,SFO,LAX
AA214,1686998189,1686998574,385,6533,American Airlines,LAX,SFO
AA214,1687006852,1687008459,1607,5783,American Airlines,SFO,LAX
AA214,1687015548,1687019444,3896,10487,American Airlines,LAX,ORD
AA214,1687040631,1687041389,758,20416,American Airlines,ORD,MKE
AA214,1687067059,1687069384,2325,9242,American Airlines,MKE,ORD
AA214,1687084178,1687085489,1311,18010,American Airlines,ORD,MKE
AA214,1687110190,1687111680,1490,19515,American Airlines,MKE,SFO
AA214,1687132439,1687140580,8141,11872,American Airlines,SFO,ORD
AA214,1687152483,1687152859,376,9677,American Airlines,ORD,MKE
AA214,1687172305,1687174012,1707,11387,American Airlines,MKE,SFO
AA214,1687194603,1687200353,5750,20624,American Airlines,SFO,ORD
AA214,1687230403,1687231893,1490,10136,American Airlines,ORD,MKE
AA214,1687246894,1687253007,6113,16730,American Airlines,MKE,ORD
AA214,1687276100,1687277461,1361,13099,American Airlines,ORD,MKE
AA214,1687297301,1687297526,225,13762,American Airlines,MKE,SFO
AA214,1687316974,1687321637,4663,13536,American Airlines,SFO,ORD
AA214,1687339509,1687340627,1118,5277,American Airlines,ORD,MKE
AA214,1687346989,1687348301,1312,6885,American Airlines,MKE,LAX
AA214,1687363769,1687365331,1562,18121,American Airlines,LAX,SFO
AA214,1687389909,1687397312,7403,5064,American Airlines,SFO,ORD
AA214,1687403833,1687403979,146,6352,American Airlines,ORD,MKE
AA214,1687416516,1687417298,782,4820,American Airlines,MKE,SFO
AA214,1687430814,1687431799,985,8901,American Airlines,SFO,LAX
AA214,1687441876,1687448502,6626,5239,American Airlines,LAX,ORD
AA214,1687463781,1687463976,195,16089,American Airlines,ORD,MKE
AA214,1687482442,1687485751,3309,17007,American Airlines,MKE,ORD
AA214,1687509523,1687510994,1471,14008,American Airlines,ORD,MKE
AA214,1687532469,1687533390,921,3987,American Airlines,MKE,SFO
AA214,1687540976,1687541683,707,13272,American Airlines,SFO,LAX
AA214,1687555665,1687564463,8798,18313,American Airlines,LAX,ORD
AA214,1687585991,1687586683,692,16408,American Airlines,ORD,MKE
AA214,1687608314,1687609847,1533,7462,American Airlines,MKE,LAX
AA214,1687624341,1687628940,4599,19128,American Airlines,LAX,ORD
AA214,1687653568,1687654439,871,20663,American Airlines,ORD,MKE
AA214,1687684722,1687685734,1012,10015,American Airlines,MKE,SFO
AA214,1687698934,1687699747,813,3920,American Airlines,SFO,LAX
AA214,1687713656,1687715202,1546,17885,American Airlines,LAX,SFO
AA214,1687739682,1687739993,311,15131,American Airlines,SFO,LAX
AA214,1687762496,1687770993,8497,9886,American Airlines,LAX,ORD
AA214,1687786962,1687788068,1106,19501,American Airlines,ORD,MKE
AA214,1687808254,1687815467,7213,18079,American Airlines,MKE,ORD
AA214,1687835206,1687835647,441,4689,American Airlines,ORD,MKE
AA214,1687850337,1687851218,881,17850,American Airlines,MKE,LAX
AA214,1687877942,1687887980,10038,6027,American Airlines,LAX,ORD
AA214,1687899852,1687899993,141,6909,American Airlines,ORD,MKE
AA214,1687912599,1687912716,117,10848,American Airlines,MKE,SFO
AA214,1687926184,1687926996,812,5376,American Airlines,SFO,LAX
AA214,1687936501,1687937690,1189,9882,American Airlines,LAX,SFO
AA214,1687953460,1687954397,937,10331,American Airlines,SFO,LAX
AA214,1687965601,1687967207,1606,15313,American Airlines,LAX,SFO
AA214,1687987669,1687996449,8780,8301,American Airlines,SFO,ORD
AA214,1688008589,1688009819,1230,9122,American Airlines,ORD,MKE
AA214,1688027064,1688028110,1046,4216,American Airlines,MKE,SFO
AA214,1688035212,1688037007,1795,7026,American Airlines,SFO,LAX
AA214,1688051806,1688051841,35,6323,American Airlines,LAX,SFO
AA214,1688058322,1688059412,1090,19190,American Airlines,SFO,LAX
AA214,1688079178,1688081743,2565,15052,American Airlines,LAX,ORD
AA214,1688100970,1688101736,766,17798,American Airlines,ORD,MKE
AA214,1688123639,1688123754,115,16735,American Airlines,MKE,LAX
AA214,1688144995,1688145349,354,16547,American Airlines,LAX,SFO
AA214,1688169065,1688169141,76,17345,American Airlines,SFO,LAX
AA214,1688190746,1688197096,6350,9445,American Airlines,LAX,ORD
AA214,1688212556,1688213759,1203,4746,American Airlines,ORD,MKE
AA214,1688229193,1688233151,3958,5447,American Airlines,MKE,ORD
AA214,1688244805,1688245615,810,11993,American Airlines,ORD,MKE
AA214,1688261236,1688261946,710,20364,American Airlines,MKE,LAX
AA214,1688283708,1688290663,6955,4049,American Airlines,LAX,ORD
AA214,1688299646,1688301181,1535,13834,American Airlines,ORD,MKE
AA214,1688324282,1688325529,1247,9181,American Airlines,MKE,SFO
AA214,1688343471,1688348067,4596,18429,American Airlines,SFO,ORD
AA214,1688369516,1688370735,1219,18677,American Airlines,ORD,MKE
AA214,1688390400,1688391250,850,6377,American Airlines,MKE,LAX
AA214,1688401365,1688403055,1690,17766,American Airlines,LAX,SFO
AA214,1688423327,1688423586,259,10352,American Airlines,SFO,LAX
AA214,1688434243,1688436009,1766,20140,American Airlines,LAX,SFO
AA214,1688459952,1688466357,6405,9489,American Airlines,SFO,ORD
AA214,1688478566,1688479826,1260,15105,American Airlines,ORD,MKE
AA214,1688498174,1688503892,5718,16320,American Airlines,MKE,ORD
AA214,1688522068,1688523755,1687,19065,American Airlines,ORD,MKE
AA214,1688542967,1688544843,1876,15640,American Airlines,MKE,ORD
AA214,1688566226,1688566420,194,18014,American Airlines,ORD,MKE
AA214,1688591241,1688595372,4131,5368,American Airlines,MKE,ORD
AA214,1688602824,1688603561,737,17648,American Airlines,ORD,MKE
AA214,1688628065,1688628943,878,16816,American Airlines,MKE,LAX
AA214,1688652870,1688663627,10757,9791,American Airlines,LAX,ORD
AA214,1688684159,1688685280,1121,11409,American Airlines,ORD,MKE
AA214,1688702698,1688704370,1672,12712,American Airlines,MKE,LAX
AA214,1688720858,1688724610,3752,18496,American Airlines,LAX,ORD
AA214,1688746617,1688747691,1074,4287,American Airlines,ORD,MKE
AA214,1688757467,1688758520,1053,19055,American Airlines,MKE,SFO
AA214,1688781692,1688781711,19,19801,American Airlines,SFO,LAX
AA214,1688808435,1688816337,7902,4155,American Airlines,LAX,ORD
AA214,1688830000,1688830640,640,14775,American Airlines,ORD,MKE
AA214,1688852187,1688853174,987,13704,American Airlines,MKE,SFO
AA214,1688867510,1688867676,166,17486,American Airlines,SFO,LAX
AA214,1688890038,1688890483,445,15892,American Airlines,LAX,SFO
AA214,1688911701,1688911833,132,10579,American Airlines,SFO,LAX
AA214,1688924642,1688925487,845,12233,American Airlines,LAX,SFO
AA214,1688945348,1688945485,137,16583,American Airlines,SFO,LAX
AA214,1688963690,1688964496,806,16878,American Airlines,LAX,SFO
AA214,1688990021,1688990812,791,14422,American Airlines,SFO,LAX
AA214,1689009749,1689010436,687,7007,American Airlines,LAX,SFO
AA214,1689018737,1689019829,1092,3992,American Airlines,SFO,LAX
AA214,1689032011,1689034658,2647,12448,American Airlines,LAX,ORD
AA214,1689052927,1689053808,881,6968,American Airlines,ORD,MKE
AA214,1689062270,1689067477,5207,21196,American Airlines,MKE,ORD
AA214,1689092991,1689094402,1411,10572,American Airlines,ORD,MKE
AA214,1689113747,1689119174,5427,11645,American Airlines,MKE,ORD
AA214,1689133688,1689135421,1733,20149,American Airlines,ORD,MKE
AA214,1689164049,1689164688,639,4388,American Airlines,MKE,LAX
AA214,1689174883,1689174923,40,14282,American Airlines,LAX,SFO
AA214,1689192594,1689198829,6235,16319,American Airlines,SFO,ORD
AA214,1689219758,1689221124,1366,6196,American Airlines,ORD,MKE
AA214,1689235772,1689236483,711,8114,American Airlines,MKE,SFO
AA214,1689249214,1689249587,373,13720,American Airlines,SFO,LAX
AA214,1689264044,1689264985,941,19235,American Airlines,LAX,SFO
AA214,1689288801,1689289491,690,13757,American Airlines,SFO,LAX
AA214,1689313322,1689315116,1794,16951,American Airlines,LAX,SFO
AA214,1689334334,1689335092,758,19800,American Airlines,SFO,LAX
AA214,1689362839,1689362863,24,6146,American Airlines,LAX,SFO
AA214,1689371592,1689371706,114,3855,American Airlines,SFO,LAX
AA214,1689382304,1689383440,1136,7004,American Airlines,LAX,SFO
AA214,1689398525,1689399502,977,8112,American Airlines,SFO,LAX
AA214,1689415382,1689416033,651,18833,American Airlines,LAX,SFO
AA214,1689435245,1689438188,2943,13452,American Airlines,SFO,ORD
AA214,1689460583,1689461736,1153,9484,American Airlines,ORD,MKE
AA214,1689474320,1689480867,6547,10251,American Airlines,MKE,ORD
AA214,1689501526,1689502361,835,19396,American Airlines,ORD,MKE
AA214,1689527827,1689528796,969,12419,American Airlines,MKE,SFO
AA214,1689543923,1689548414,4491,5522,American Airlines,SFO,ORD
AA214,1689560096,1689561636,1540,17356,American Airlines,ORD,MKE
AA214,1689581545,1689582951,1406,5721,American Airlines,MKE,LAX
AA214,1689597770,1689607623,9853,8136,American Airlines,LAX,ORD
AA214,1689621582,1689623317,1735,16547,American Airlines,ORD,MKE
AA214,1689642707,1689653154,10447,13009,American Airlines,MKE,ORD
AA214,1689673432,1689673465,33,5886,American Airlines,ORD,MKE
AA214,1689683884,1689688859,4975,5824,American Airlines,MKE,ORD
AA214,1689700771,1689701040,269,18931,American Airlines,ORD,MKE
AA214,1689724141,1689725104,963,6023,American Airlines,MKE,SFO
AA214,1689739120,1689748665,9545,4182,American Airlines,SFO,ORD
AA214,1689755935,1689756807,872,8840,American Airlines,ORD,MKE
AA214,1689772955,1689773274,319,14646,American Airlines,MKE,SFO
AA214,1689791175,1689791330,155,15261,American Airlines,SFO,LAX
AA214,1689814206,1689814521,315,12491,American Airlines,LAX,SFO
AA214,1689828744,1689835313,6569,14320,American Airlines,SFO,ORD
AA214,1689855360,1689856952,1592,15048,American Airlines,ORD,MKE
AA214,1689878004,1689879613,1609,15621,American Airlines,MKE,LAX
AA214,1689899176,1689900975,1799,16887,American Airlines,LAX,SFO
AA214,1689922713,1689924296,1583,4503,American Airlines,SFO,LAX
AA214,1689935384,1689945478,10094,20085,American Airlines,LAX,ORD
AA214,1689975171,1689976033,862,6013,American Airlines,ORD,MKE
AA214,1689991572,1689992719,1147,17876,American Airlines,MKE,SFO
AA214,1690017233,1690027498,10265,8553,American Airlines,SFO,ORD
AA214,1690037319,1690037961,642,3869,American Airlines,ORD,MKE
AA214,1690052268,1690052393,125,12985,American Airlines,MKE,SFO
AA214,1690069625,1690071410,1785,17462,American Airlines,SFO,LAX
AA214,1690098520,1690100448,1928,6245,American Airlines,LAX,ORD
AA214,1690109236,1690110199,963,4867,American Airlines,ORD,MKE
AA214,1690117594,1690119376,1782,13393,American Airlines,MKE,LAX
AA214,1690136712,1690138275,1563,17775,American Airlines,LAX,SFO
AA214,1690158300,1690159914,1614,9544,American Airlines,SFO,LAX
AA214,1690178109,1690180565,2456,3873,American Airlines,LAX,ORD
AA214,1690191464,1690191644,180,7844,American Airlines,ORD,MKE
AA214,1690208384,1690216476,8092,6687,American Airlines,MKE,ORD
AA214,1690229157,1690229963,806,20080,American Airlines,ORD,MKE
AA214,1690252996,1690254076,1080,10917,American Airlines,MKE,LAX
AA214,1690267174,1690275067,7893,13066,American Airlines,LAX,ORD
AA214,1690298489,1690298659,170,20324,American Airlines,ORD,MKE
AA214,1690324099,1690325125,1026,20159,American Airlines,MKE,SFO
AA214,1690349566,1690350003,437,12378,American Airlines,SFO,LAX
AA214,1690370433,1690372881,2448,20834,American Airlines,LAX,ORD
AA214,1690394787,1690395185,398,14593,American Airlines,ORD,MKE
AA214,1690412964,1690414617,1653,9000,American Airlines,MKE,LAX
AA214,1690433926,1690435427,1501,12943,American Airlines,LAX,SFO
AA214,1690458279,1690459582,1303,18545,American Airlines,SFO,LAX
AA214,1690479673,1690481661,1988,21161,American Airlines,LAX,ORD
AA214,1690506606,1690507880,1274,5863,American Airlines,ORD,MKE
AA214,1690521214,1690522300,1086,16428,American Airlines,MKE,SFO
AA214,1690545449,1690548384,2935,20982,American Airlines,SFO,ORD
AA214,1690576085,1690576705,620,6800,American Airlines,ORD,MKE
AA214,1690593705,1690595339,1634,7550,American Airlines,MKE,SFO
AA214,1690606895,1690607720,825,17158,American Airlines,SFO,LAX
AA214,1690630550,1690635159,4609,17347,American Airlines,LAX,ORD
AA214,1690662255,1690662763,508,18220,American Airlines,ORD,MKE
AA214,1690681899,1690682077,178,12389,American Airlines,MKE,LAX
AA214,1690701885,1690702858,973,10618,American Airlines,LAX,SFO
AA214,1690717435,1690718744,1309,17277,American Airlines,SFO,LAX
AA214,1690737917,1690745946,8029,4711,American Airlines,LAX,ORD
AA214,1690756534,1690758055,1521,17849,American Airlines,ORD,MKE
AA214,1690783181,1690784214,1033,10749,American Airlines,MKE,LAX
AA214,1690802596,1690802757,161,9616,American Airlines,LAX,SFO
AA214,1690815619,1690825574,9955,5354,American Airlines,SFO,ORD
AA214,1690838450,1690839974,1524,13293,American Airlines,ORD,MKE
AA214,1690862771,1690864241,1470,4283,American Airlines,MKE,LAX
AA214,1690872363,1690873289,926,17677,American Airlines,LAX,SFO
AA214,1690896561,1690898368,1807,9768,American Airlines,SFO,ORD
AA214,1690909892,1690910403,511,17028,American Airlines,ORD,MKE
AA214,1690937829,1690945578,7749,4506,American Airlines,MKE,ORD
AA214,1690957021,1690958749,1728,5257,American Airlines,ORD,MKE
AA214,1690970957,1690972964,2007,13129,American Airlines,MKE,ORD
AA214,1690990381,1690992003,1622,7308,American Airlines,ORD,MKE
AA214,1691003286,1691003777,491,20296,American Airlines,MKE,SFO
AA214,1691031870,1691041158,9288,15031,American Airlines,SFO,ORD
AA214,1691063974,1691065261,1287,20344,American Airlines,ORD,MKE
AA214,1691094838,1691100520,5682,3673,American Airlines,MKE,ORD
AA214,1691104494,1691104825,331,16752,American Airlines,ORD,MKE
AA214,1691128871,1691129344,473,6449,American Airlines,MKE,SFO
AA214,1691144668,1691146465,1797,14394,American Airlines,SFO,LAX
AA214,1691164541,1691170687,6146,3854,American Airlines,LAX,ORD
AA214,1691183414,1691184539,1125,19585,American Airlines,ORD,MKE
AA214,1691212309,1691220401,8092,3793,American Airlines,MKE,ORD
AA214,1691230292,1691231190,898,11803,American Airlines,ORD,MKE
AA214,1691250806,1691251364,558,12755,American Airlines,MKE,LAX
AA214,1691272952,1691274679,1727,17601,American Airlines,LAX,SFO
AA214,1691295488,1691296868,1380,4508,American Airlines,SFO,LAX
AA214,1691302197,1691305810,3613,3600,American Airlines,LAX,ORD
AA214,1691314994,1691316574,1580,16928,American Airlines,ORD,MKE
AA214,1691334841,1691335786,945,8902,American Airlines,MKE,LAX
AA214,1691354003,1691357822,3819,8558,American Airlines,LAX,ORD
AA214,1691369320,1691369518,198,5628,American Airlines,ORD,MKE
AA214,1691382374,1691383066,692,8996,American Airlines,MKE,SFO
AA214,1691398332,1691408794,10462,8844,American Airlines,SFO,ORD
AA214,1691427427,1691428021,594,14344,American Airlines,ORD,MKE
AA214,1691449246,1691460009,10763,9100,American Airlines,MKE,ORD
AA214,1691479230,1691479862,632,20237,American Airlines,ORD,MKE
AA214,1691506188,1691507300,1112,18289,American Airlines,MKE,SFO
AA214,1691532851,1691540960,8109,17399,American Airlines,SFO,ORD
AA214,1691567190,1691567201,11,14703,American Airlines,ORD,MKE
AA214,1691590781,1691591536,755,14522,American Airlines,MKE,LAX
AA214,1691608525,1691609346,821,6035,American Airlines,LAX,SFO
AA214,1691624610,1691629160,4550,18350,American Airlines,SFO,ORD
AA214,1691655443,1691657155,1712,9797,American Airlines,ORD,MKE
AA214,1691671303,1691671662,359,12872,American Airlines,MKE,LAX
AA214,1691689290,1691693725,4435,17363,American Airlines,LAX,ORD
AA214,1691721133,1691721469,336,6136,American Airlines,ORD,MKE
AA214,1691735295,1691735494,199,17843,American Airlines,MKE,SFO
AA214,1691754319,1691755464,1145,6139,American Airlines,SFO,LAX
AA214,1691766893,1691774548,7655,18691,American Airlines,LAX,ORD
AA214,1691796514,1691797286,772,16723,American Airlines,ORD,MKE
AA214,1691822188,1691822286,98,18469,American Airlines,MKE,SFO
AA214,1691849087,1691855117,6030,13092,American Airlines,SFO,ORD
AA214,1691874895,1691876046,1151,20988,American Airlines,ORD,MKE
AA214,1691898236,1691907043,8807,4549,American Airlines,MKE,ORD
AA214,1691912601,1691913662,1061,19556,American Airlines,ORD,MKE
AA214,1691940286,1691946575,6289,10468,American Airlines,MKE,ORD
AA214,1691959374,1691961056,1682,3683,American Airlines,ORD,MKE
AA214,1691966694,1691967547,853,19507,American Airlines,MKE,SFO
AA214,1691990665,1691996781,6116,14686,American Airlines,SFO,ORD
AA214,1692012528,1692012637,109,19211,American Airlines,ORD,MKE
AA214,1692034179,1692034774,595,4634,American Airlines,MKE,SFO
AA214,1692046617,1692056426,9809,21444,American Airlines,SFO,ORD
AA214,1692088065,1692088299,234,9040,American Airlines,ORD,MKE
AA214,1692106645,1692106776,131,17499,American Airlines,MKE,SFO
AA214,1692134599,1692136278,1679,16582,American Airlines,SFO,LAX
AA214,1692160671,1692160890,219,15125,American Airlines,LAX,SFO
AA214,1692181464,1692186675,5211,5029,American Airlines,SFO,ORD
AA214,1692194743,1692194903,160,17859,American Airlines,ORD,MKE
AA214,1692217580,1692225897,8317,5600,American Airlines,MKE,ORD
AA214,1692234934,1692235041,107,6013,American Airlines,ORD,MKE
AA214,1692243623,1692244673,1050,12073,American Airlines,MKE,LAX
AA214,1692260262,1692263120,2858,11896,American Airlines,LAX,ORD
AA214,1692275391,1692276147,756,3984,American Airlines,ORD,MKE
AA214,1692281883,1692282602,719,8160,American Airlines,MKE,LAX
AA214,1692295823,1692306105,10282,20173,American Airlines,LAX,ORD
AA214,1692334177,1692335005,828,20030,American Airlines,ORD,MKE
AA214,1692357733,1692362382,4649,15898,American Airlines,MKE,ORD
AA214,1692386758,1692387653,895,9300,American Airlines,ORD,MKE
AA214,1692400130,1692400566,436,9617,American Airlines,MKE,LAX
AA214,1692417971,1692419146,1175,17280,American Airlines,LAX,SFO
AA214,1692444621,1692445388,767,18353,American Airlines,SFO,LAX
AA214,1692468076,1692468782,706,9178,American Airlines,LAX,SFO
AA214,1692481705,1692483184,1479,13888,American Airlines,SFO,LAX
AA214,1692499053,1692509704,10651,6894,American Airlines,LAX,ORD
AA214,1692518907,1692520447,1540,4873,American Airlines,ORD,MKE
AA214,1692525588,1692525899,311,10239,American Airlines,MKE,SFO
AA214,1692538770,1692538822,52,9475,American Airlines,SFO,LAX
AA214,1692555173,1692555940,767,11772,American Airlines,LAX,SFO
AA214,1692569682,1692579167,9485,15972,American Airlines,SFO,ORD
AA214,1692605348,1692607080,1732,12265,American Airlines,ORD,MKE
AA214,1692619438,1692626596,7158,17448,American Airlines,MKE,ORD
AA214,1692644908,1692646402,1494,12677,American Airlines,ORD,MKE
AA214,1692662381,1692672439,10058,17334,American Airlines,MKE,ORD
AA214,1692698746,1692699172,426,13352,American Airlines,ORD,MKE
AA214,1692714938,1692723737,8799,15565,American Airlines,MKE,ORD
AA214,1692740914,1692742124,1210,4443,American Airlines,ORD,MKE
AA214,1692755160,1692755716,556,3601,American Airlines,MKE,SFO
AA214,1692762811,1692773476,10665,4289,American Airlines,SFO,ORD
AA214,1692782484,1692783697,1213,21509,American Airlines,ORD,MKE
AA214,1692813961,1692814003,42,15103,American Airlines,MKE,LAX
AA214,1692838338,1692839073,735,8728,American Airlines,LAX,SFO
AA214,1692857326,1692863322,5996,6221,American Airlines,SFO,ORD
AA214,1692870914,1692871618,704,11266,American Airlines,ORD,MKE
AA214,1692883147,1692887844,4697,7997,American Airlines,MKE,ORD
AA214,1692903200,1692904673,1473,12361,American Airlines,ORD,MKE
AA214,1692921292,1692922925,1633,21131,American Airlines,MKE,SFO
AA214,1692954715,1692964817,10102,4903,American Airlines,SFO,ORD
AA214,1692978441,1692979449,1008,18196,American Airlines,ORD,MKE
AA214,1693006923,1693015398,8475,7553,American Airlines,MKE,ORD
AA214,1693023182,1693024063,881,21017,American Airlines,ORD,MKE
AA214,1693054895,1693055206,311,15588,American Airlines,MKE,SFO
AA214,1693080020,1693081683,1663,5363,American Airlines,SFO,LAX
AA214,1693087585,1693097597,10012,6696,American Airlines,LAX,ORD
AA214,1693112959,1693113413,454,15860,American Airlines,ORD,MKE
AA214,1693132878,1693134592,1714,11568,American Airlines,MKE,SFO
AA214,1693151088,1693152725,1637,10902,American Airlines,SFO,LAX
AA214,1693165997,1693167758,1761,8001,American Airlines,LAX,SFO
AA214,1693180640,1693188810,8170,10622,American Airlines,SFO,ORD
AA214,1693206318,1693206718,400,10471,American Airlines,ORD,MKE
AA214,1693222588,1693223015,427,13169,American Airlines,MKE,SFO
AA214,1693238360,1693238729,369,20447,American Airlines,SFO,LAX
AA214,1693265728,1693269618,3890,4119,American Airlines,LAX,ORD
AA214,1693284174,1693285144,970,10916,American Airlines,ORD,MKE
AA214,1693303276,1693304355,1079,15295,American Airlines,MKE,LAX
AA214,1693324872,1693327228,2356,10644,American Airlines,LAX,ORD
AA214,1693348272,1693348861,589,11478,American Airlines,ORD,MKE
AA214,1693368726,1693369864,1138,19428,American Airlines,MKE,SFO
AA214,1693393195,1693393423,228,18876,American Airlines,SFO,LAX
AA214,1693418801,1693425648,6847,20639,American Airlines,LAX,ORD
AA214,1693452774,1693453369,595,18845,American Airlines,ORD,MKE
AA214,1693482949,1693484508,1559,11051,American Airlines,MKE,SFO
AA214,1693497219,1693502444,5225,6594,American Airlines,SFO,ORD
AA214,1693512886,1693513595,709,6971,American Airlines,ORD,MKE
AA214,1693524044,1693533762,9718,13136,American Airlines,MKE,ORD
AA214,1693556464,1693556959,495,19267,American Airlines,ORD,MKE
AA214,1693576584,1693577427,843,4928,American Airlines,MKE,LAX
AA214,1693588107,1693588235,128,14020,American Airlines,LAX,SFO
AA214,1693605302,1693614823,9521,6180,American Airlines,SFO,ORD
AA214,1693630216,1693631925,1709,11455,American Airlines,ORD,MKE
AA214,1693644777,1693645455,678,20498,American Airlines,MKE,SFO
AA214,1693673024,1693680364,7340,12503,American Airlines,SFO,ORD
AA214,1693693831,1693695621,1790,14994,American Airlines,ORD,MKE
AA214,1693720524,1693721864,1340,17760,American Airlines,MKE,SFO
AA214,1693750087,1693751059,972,21155,American Airlines,SFO,LAX
AA214,1693781138,1693783023,1885,13095,American Airlines,LAX,ORD
AA214,1693799642,1693800662,1020,8646,American Airlines,ORD,MKE
AA214,1693818856,1693820390,1534,9468,American Airlines,MKE,SFO
AA214,1693830453,1693831309,856,11883,American Airlines,SFO,LAX
AA214,1693851484,1693857713,6229,11991,American Airlines,LAX,ORD
AA214,1693871964,1693873574,1610,15224,American Airlines,ORD,MKE
AA214,1693895258,1693896794,1536,10530,American Airlines,MKE,LAX
AA214,1693911160,1693917107,5947,19335,American Airlines,LAX,ORD
AA214,1693945569,1693947079,1510,19810,American Airlines,ORD,MKE
AA214,1693977663,1693985557,7894,12590,American Airlines,MKE,ORD
AA214,1694001573,1694002292,719,21434,American Airlines,ORD,MKE
AA214,1694026357,1694026810,453,20285,American Airlines,MKE,SFO
AA214,1694051098,1694055701,4603,19030,American Airlines,SFO,ORD
AA214,1694076929,1694077324,395,9104,American Airlines,ORD,MKE
AA214,1694088117,1694089822,1705,12195,American Airlines,MKE,SFO
AA214,1694109003,1694110752,1749,5371,American Airlines,SFO,LAX
AA214,1694126300,1694127541,1241,4950,American Airlines,LAX,SFO
AA214,1694140010,1694141804,1794,19667,American Airlines,SFO,LAX
AA214,1694171304,1694171877,573,8872,American Airlines,LAX,SFO
AA214,1694184256,1694185208,952,6148,American Airlines,SFO,LAX
AA214,1694199813,1694203374,3561,18961,American Airlines,LAX,ORD
AA214,1694222621,1694224188,1567,8483,American Airlines,ORD,MKE
AA214,1694240759,1694251419,10660,3840,American Airlines,MKE,ORD
AA214,1694264910,1694265886,976,8097,American Airlines,ORD,MKE
AA214,1694276865,1694277955,1090,8661,American Airlines,MKE,SFO
AA214,1694294808,1694304219,9411,11792,American Airlines,SFO,ORD
AA214,1694325336,1694325439,103,6767,American Airlines,ORD,MKE
AA214,1694339772,1694346761,6989,5864,American Airlines,MKE,ORD
AA214,1694360129,1694361131,1002,15924,American Airlines,ORD,MKE
AA214,1694379907,1694380278,371,5493,American Airlines,MKE,SFO
AA214,1694388948,1694389387,439,7584,American Airlines,SFO,LAX
AA214,1694399868,1694400983,1115,20202,American Airlines,LAX,SFO
AA214,1694430635,1694431048,413,8560,American Airlines,SFO,LAX
AA214,1694449978,1694451406,1428,21055,American Airlines,LAX,SFO
AA214,1694481866,1694482520,654,5373,American Airlines,SFO,LAX
AA214,1694497411,1694505257,7846,8461,American Airlines,LAX,ORD
AA214,1694520650,1694521315,665,13544,American Airlines,ORD,MKE
AA214,1694537019,1694538190,1171,17779,American Airlines,MKE,LAX
AA214,1694560448,1694568422,7974,21280,American Airlines,LAX,ORD
AA214,1694596827,1694598361,1534,19732,American Airlines,ORD,MKE
AA214,1694622522,1694628553,6031,6722,American Airlines,MKE,ORD
AA214,1694640881,1694641515,634,15305,American Airlines,ORD,MKE
AA214,1694657053,1694665522,8469,19050,American Airlines,MKE,ORD
AA214,1694693338,1694693409,71,7305,American Airlines,ORD,MKE
AA214,1694703887,1694704866,979,5470,American Airlines,MKE,LAX
AA214,1694712782,1694713240,458,7132,American Airlines,LAX,SFO
AA214,1694728263,1694728531,268,13093,American Airlines,SFO,LAX
AA214,1694751906,1694752541,635,8423,American Airlines,LAX,SFO
AA214,1694766918,1694768199,1281,13387,American Airlines,SFO,LAX
AA214,1694791767,1694792119,352,16859,American Airlines,LAX,SFO
AA214,1694813010,1694821623,8613,12012,American Airlines,SFO,ORD
AA214,1694844038,1694845660,1622,16156,American Airlines,ORD,MKE
AA214,1694872155,1694873745,1590,6986,American Airlines,MKE,SFO
AA214,1694890150,1694891168,1018,21417,American Airlines,SFO,LAX
AA214,1694923124,1694926969,3845,8050,American Airlines,LAX,ORD
AA214,1694940748,1694940749,1,8131,American Airlines,ORD,MKE
AA214,1694954198,1694964697,10499,6946,American Airlines,MKE,ORD
AA214,1694974035,1694975730,1695,8357,American Airlines,ORD,MKE
AA214,1694987210,1694988330,1120,9721,American Airlines,MKE,LAX
AA214,1694999645,1695007540,7895,3614,American Airlines,LAX,ORD
AA214,1695011302,1695011865,563,6394,American Airlines,ORD,MKE
AA214,1695028417,1695036303,7886,12585,American Airlines,MKE,ORD
AA214,1695057217,1695057512,295,10020,American Airlines,ORD,MKE
AA214,1695077588,1695078587,999,18168,American Airlines,MKE,LAX
AA214,1695103133,1695113273,10140,21305,American Airlines,LAX,ORD
AA214,1695136440,1695137779,1339,20436,American Airlines,ORD,MKE
AA214,1695163656,1695170588,6932,14089,American Airlines,MKE,ORD
AA214,1695184951,1695186064,1113,9470,American Airlines,ORD,MKE
AA214,1695195648,1695196614,966,4201,American Airlines,MKE,LAX
AA214,1695201092,1695202045,953,5149,American Airlines,LAX,SFO
AA214,1695207936,1695218480,10544,7425,American Airlines,SFO,ORD
AA214,1695235972,1695237278,1306,17421,American Airlines,ORD,MKE
AA214,1695256011,1695259248,3237,9941,American Airlines,MKE,ORD
AA214,1695275319,1695275900,581,19402,American Airlines,ORD,MKE
AA214,1695305155,1695305443,288,12194,American Airlines,MKE,SFO
AA214,1695323573,1695325186,1613,20245,American Airlines,SFO,LAX
AA214,1695354603,1695357274,2671,5991,American Airlines,LAX,ORD
AA214,1695369184,1695370720,1536,16959,American Airlines,ORD,MKE
AA214,1695390993,1695392289,1296,19505,American Airlines,MKE,SFO
AA214,1695416325,1695421116,4791,7633,American Airlines,SFO,ORD
AA214,1695432772,1695434188,1416,17698,American Airlines,ORD,MKE
AA214,1695459233,1695462547,3314,5840,American Airlines,MKE,ORD
AA214,1695472889,1695474101,1212,7363,American Airlines,ORD,MKE
AA214,1695490509,1695499173,8664,14415,American Airlines,MKE,ORD
AA214,1695522308,1695523296,988,18382,American Airlines,ORD,MKE
AA214,1695551939,1695552796,857,5962,American Airlines,MKE,LAX
AA214,1695566945,1695568328,1383,8093,American Airlines,LAX,SFO
AA214,1695582936,1695583184,248,10258,American Airlines,SFO,LAX
AA214,1695602449,1695609110,6661,3846,American Airlines,LAX,ORD
AA214,1695614822,1695616155,1333,6693,American Airlines,ORD,MKE
AA214,1695623491,1695625322,1831,20795,American Airlines,MKE,ORD
AA214,1695650739,1695652462,1723,5981,American Airlines,ORD,MKE
AA214,1695663934,1695664310,376,19106,American Airlines,MKE,SFO
AA214,1695691585,1695702250,10665,5491,American Airlines,SFO,ORD
AA214,1695716788,1695717924,1136,21164,American Airlines,ORD,MKE
AA214,1695748280,1695749933,1653,9226,American Airlines,MKE,SFO
AA214,1695767888,1695778606,10718,16138,American Airlines,SFO,ORD
AA214,1695804583,1695805808,1225,15559,American Airlines,ORD,MKE
AA214,1695829781,1695830517,736,11376,American Airlines,MKE,SFO
AA214,1695852047,1695853607,1560,16669,American Airlines,SFO,LAX
AA214,1695877174,1695886396,9222,17368,American Airlines,LAX,ORD
AA214,1695908467,1695909457,990,19624,American Airlines,ORD,MKE
AA214,1695929212,1695935878,6666,7286,American Airlines,MKE,ORD
AA214,1695951523,1695952127,604,5309,American Airlines,ORD,MKE
AA214,1695963760,1695964195,435,17372,American Airlines,MKE,SFO
AA214,1695984302,1695994653,10351,4827,American Airlines,SFO,ORD
AA214,1696006140,1696007111,971,8948,American Airlines,ORD,MKE
AA214,1696018626,1696018749,123,19073,American Airlines,MKE,LAX
AA214,1696048552,1696049148,596,5693,American Airlines,LAX,SFO
AA214,1696064280,1696074791,10511,20269,American Airlines,SFO,ORD
AA214,1696101579,1696102519,940,20622,American Airlines,ORD,MKE
AA214,1696128702,1696128875,173,17239,American Airlines,MKE,LAX
AA214,1696147230,1696155322,8092,19904,American Airlines,LAX,ORD
AA214,1696177267,1696178472,1205,15143,American Airlines,ORD,MKE
AA214,1696201520,1696202732,1212,15157,American Airlines,MKE,LAX
AA214,1696221231,1696221935,704,7842,American Airlines,LAX,SFO
AA214,1696238459,1696238676,217,8449,American Airlines,SFO,LAX
AA214,1696248907,1696249880,973,14343,American Airlines,LAX,SFO
AA214,1696265433,1696268268,2835,8108,American Airlines,SFO,ORD
AA214,1696282070,1696282840,770,18795,American Airlines,ORD,MKE
AA214,1696305712,1696315166,9454,14860,American Airlines,MKE,ORD
AA214,1696339352,1696339620,268,3827,American Airlines,ORD,MKE
AA214,1696346993,1696347950,957,14140,American Airlines,MKE,LAX
AA214,1696370071,1696379404,9333,8733,American Airlines,LAX,ORD
AA214,1696397808,1696399533,1725,4233,American Airlines,ORD,MKE
AA214,1696405002,1696405928,926,17331,American Airlines,MKE,LAX
AA214,1696429219,1696433404,4185,20704,American Airlines,LAX,ORD
AA214,1696462252,1696462693,441,17588,American Airlines,ORD,MKE
AA214,1696488727,1696490549,1822,7496,American Airlines,MKE,ORD
AA214,1696498939,1696500153,1214,8730,American Airlines,ORD,MKE
AA214,1696513905,1696514518,613,19333,American Airlines,MKE,LAX
AA214,1696536301,1696537639,1338,4100,American Airlines,LAX,SFO
AA214,1696550349,1696552481,2132,9177,American Airlines,SFO,ORD
AA214,1696570896,1696571767,871,14055,American Airlines,ORD,MKE
AA214,1696591970,1696591986,16,15900,American Airlines,MKE,SFO
AA214,1696612115,1696612820,705,19120,American Airlines,SFO,LAX
AA214,1696632030,1696638411,6381,16221,American Airlines,LAX,ORD
AA214,1696664133,1696664996,863,15162,American Airlines,ORD,MKE
AA214,1696683725,1696691191,7466,4373,American Airlines,MKE,ORD
AA214,1696696026,1696696667,641,6968,American Airlines,ORD,MKE
AA214,1696707058,1696714779,7721,19034,American Airlines,MKE,ORD
AA214,1696735186,1696736354,1168,20083,American Airlines,ORD,MKE
AA214,1696761891,1696762663,772,15653,American Airlines,MKE,SFO
AA214,1696784835,1696794258,9423,10545,American Airlines,SFO,ORD
AA214,1696810305,1696811723,1418,7491,American Airlines,ORD,MKE
AA214,1696826075,1696827816,1741,4317,American Airlines,MKE,LAX
AA214,1696834951,1696842099,7148,21539,American Airlines,LAX,ORD
AA214,1696866547,1696867375,828,17814,American Airlines,ORD,MKE
AA214,1696895515,1696896550,1035,10431,American Airlines,MKE,LAX
AA214,1696907112,1696908850,1738,13229,American Airlines,LAX,SFO
AA214,1696932846,1696935957,3111,13265,American Airlines,SFO,ORD
AA214,1696959532,1696959964,432,7389,American Airlines,ORD,MKE
AA214,1696967507,1696968073,566,9370,American Airlines,MKE,SFO
AA214,1696980687,1696982473,1786,19930,American Airlines,SFO,LAX
AA214,1697006876,1697008437,1561,6728,American Airlines,LAX,SFO
AA214,1697017570,1697017834,264,14498,American Airlines,SFO,LAX
AA214,1697040963,1697041109,146,6768,American Airlines,LAX,SFO
AA214,1697049059,1697055062,6003,12778,American Airlines,SFO,ORD
AA214,1697074067,1697075491,1424,14471,American Airlines,ORD,MKE
AA214,1697099407,1697101900,2493,12150,American Airlines,MKE,ORD
AA214,1697123981,1697124901,920,7665,American Airlines,ORD,MKE
AA214,1697139975,1697140583,608,9761,American Airlines,MKE,LAX
AA214,1697159465,1697168831,9366,13307,American Airlines,LAX,ORD
AA214,1697183223,1697183436,213,8122,American Airlines,ORD,MKE
AA214,1697201339,1697202707,1368,14406,American Airlines,MKE,LAX
AA214,1697227663,1697230258,2595,10349,American Airlines,LAX,ORD
AA214,1697245084,1697246386,1302,8357,American Airlines,ORD,MKE
AA214,1697259417,1697259575,158,10052,American Airlines,MKE,SFO
AA214,1697280361,1697281041,680,20358,American Airlines,SFO,LAX
AA214,1697309936,1697316808,6872,8713,American Airlines,LAX,ORD
AA214,1697334119,1697335079,960,13528,American Airlines,ORD,MKE
AA214,1697351210,1697354625,3415,20299,American Airlines,MKE,ORD
AA214,1697379367,1697379590,223,13395,American Airlines,ORD,MKE
AA214,1697397721,1697401067,3346,6944,American Airlines,MKE,ORD
AA214,1697412336,1697412796,460,6268,American Airlines,ORD,MKE
AA214,1697421744,1697421775,31,8612,American Airlines,MKE,SFO
AA214,1697432131,1697433060,929,18938,American Airlines,SFO,LAX
AA214,1697462420,1697463785,1365,21493,American Airlines,LAX,SFO
AA214,1697492779,1697497054,4275,16251,American Airlines,SFO,ORD
AA214,1697519585,1697521012,1427,7688,American Airlines,ORD,MKE
AA214,1697534178,1697535682,1504,19841,American Airlines,MKE,LAX
AA214,1697564736,1697567887,3151,7084,American Airlines,LAX,ORD
AA214,1697580485,1697582177,1692,13302,American Airlines,ORD,MKE
AA214,1697596110,1697597829,1719,5816,American Airlines,MKE,LAX
AA214,1697608207,1697609168,961,21307,American Airlines,LAX,SFO
AA214,1697630621,1697630937,316,7561,American Airlines,SFO,LAX
AA214,1697646183,1697650106,3923,20309,American Airlines,LAX,ORD
AA214,1697679511,1697679768,257,14330,American Airlines,ORD,MKE
AA214,1697694932,1697704056,9124,4344,American Airlines,MKE,ORD
AA214,1697717208,1697718030,822,18792,American Airlines,ORD,MKE
AA214,1697744578,1697746293,1715,19713,American Airlines,MKE,LAX
AA214,1697773979,1697774138,159,9139,American Airlines,LAX,SFO
AA214,1697790746,1697793328,2582,12501,American Airlines,SFO,ORD
AA214,1697814023,1697814172,149,13367,American Airlines,ORD,MKE
AA214,1697828679,1697832314,3635,17096,American Airlines,MKE,ORD
AA214,1697854495,1697855310,815,10762,American Airlines,ORD,MKE
AA214,1697872086,1697875347,3261,19222,American Airlines,MKE,ORD
AA214,1697896639,1697896676,37,18727,American Airlines,ORD,MKE
AA214,1697923060,1697930120,7060,8987,American Airlines,MKE,ORD
AA214,1697948837,1697949152,315,13075,American Airlines,ORD,MKE
AA214,1697971405,1697975039,3634,9835,American Airlines,MKE,ORD
AA214,1697994773,1697995462,689,12019,American Airlines,ORD,MKE
AA214,1698014989,1698016503,1514,6017,American Airlines,MKE,SFO
AA214,1698023901,1698024564,663,7258,American Airlines,SFO,LAX
AA214,1698037238,1698037498,260,5444,American Airlines,LAX,SFO
AA214,1698044912,1698045887,975,4521,American Airlines,SFO,LAX
AA214,1698056557,1698057549,992,6199,American Airlines,LAX,SFO
AA214,1698065049,1698075756,10707,4180,American Airlines,SFO,ORD
AA214,1698090267,1698090323,56,17480,American Airlines,ORD,MKE
AA214,1698115444,1698123266,7822,7562,American Airlines,MKE,ORD
AA214,1698131056,1698131843,787,5107,American Airlines,ORD,MKE
AA214,1698143638,1698145432,1794,12599,American Airlines,MKE,SFO
AA214,1698164922,1698166235,1313,19659,American Airlines,SFO,LAX
AA214,1698192789,1698198758,5969,18535,American Airlines,LAX,ORD
AA214,1698227041,1698228562,1521,5738,American Airlines,ORD,MKE
AA214,1698244886,1698253947,9061,19186,American Airlines,MKE,ORD
AA214,1698283927,1698283973,46,3915,American Airlines,ORD,MKE
AA214,1698291527,1698301505,9978,20120,American Airlines,MKE,ORD
AA214,1698324522,1698325469,947,9242,American Airlines,ORD,MKE
AA214,1698338971,1698340586,1615,6882,American Airlines,MKE,SFO
AA214,1698357743,1698362095,4352,5544,American Airlines,SFO,ORD
AA214,1698367750,1698369516,1766,17831,American Airlines,ORD,MKE
AA214,1698397699,1698402457,4758,18584,American Airlines,MKE,ORD
AA214,1698430283,1698431753,1470,20495,American Airlines,ORD,MKE
AA214,1698462480,1698467111,4631,19328,American Airlines,MKE,ORD
AA214,1698496646,1698497771,1125,10130,American Airlines,ORD,MKE
SW109,1682959659,1682961024,1365,15734,Southwest Airlines,ORD,MKE
SW109,1682986830,1682991170,4340,4530,Southwest Airlines,MKE,ORD
SW109,1682999739,1683001514,1775,11580,Southwest Airlines,ORD,MKE
SW109,1683022970,1683024343,1373,9838,Southwest Airlines,MKE,SFO
SW109,1683044879,1683054649,9770,4033,Southwest Airlines,SFO,ORD
SW109,1683063309,1683063713,404,21205,Southwest Airlines,ORD,MKE
SW109,1683086918,1683095834,8916,13300,Southwest Airlines,MKE,ORD
SW109,1683116101,1683117108,1007,14519,Southwest Airlines,ORD,MKE
SW109,1683134380,1683139654,5274,18531,Southwest Airlines,MKE,ORD
SW109,1683163464,1683164586,1122,8974,Southwest Airlines,ORD,MKE
SW109,1683179682,1683187003,7321,5491,Southwest Airlines,MKE,ORD
SW109,1683196116,1683196606,490,12555,Southwest Airlines,ORD,MKE
SW109,1683219131,1683219194,63,7862,Southwest Airlines,MKE,SFO
SW109,1683233659,1683238111,4452,9594,Southwest Airlines,SFO,ORD
SW109,1683258082,1683259190,1108,13210,Southwest Airlines,ORD,MKE
SW109,1683273141,1683281804,8663,7797,Southwest Airlines,MKE,ORD
SW109,1683292919,1683293780,861,11656,Southwest Airlines,ORD,MKE
SW109,1683309753,1683310558,805,9189,Southwest Airlines,MKE,SFO
SW109,1683329661,1683332228,2567,8598,Southwest Airlines,SFO,ORD
SW109,1683347831,1683348603,772,18532,Southwest Airlines,ORD,MKE
SW109,1683369501,1683371019,1518,20213,Southwest Airlines,MKE,LAX
SW109,1683401481,1683411123,9642,16311,Southwest Airlines,LAX,ORD
SW109,1683433395,1683435062,1667,8019,Southwest Airlines,ORD,MKE
SW109,1683446977,1683448570,1593,15179,Southwest Airlines,MKE,SFO
SW109,1683464115,1683474639,10524,20460,Southwest Airlines,SFO,ORD
SW109,1683497221,1683498630,1409,20469,Southwest Airlines,ORD,MKE
SW109,1683526696,1683528131,1435,7668,Southwest Airlines,MKE,LAX
SW109,1683538634,1683542177,3543,9002,Southwest Airlines,LAX,ORD
SW109,1683560867,1683561484,617,14773,Southwest Airlines,ORD,MKE
SW109,1683579588,1683581080,1492,16047,Southwest Airlines,MKE,LAX
SW109,1683602391,1683603101,710,10965,Southwest Airlines,LAX,SFO
SW109,1683618821,1683620250,1429,8945,Southwest Airlines,SFO,LAX
SW109,1683632672,1683636059,3387,3806,Southwest Airlines,LAX,ORD
SW109,1683648738,1683650017,1279,20020,Southwest Airlines,ORD,MKE
SW109,1683674868,1683681627,6759,4092,Southwest Airlines,MKE,ORD
SW109,1683694235,1683695913,1678,4055,Southwest Airlines,ORD,MKE
SW109,1683709555,1683714568,5013,14972,Southwest Airlines,MKE,ORD
SW109,1683738844,1683739228,384,13958,Southwest Airlines,ORD,MKE
SW109,1683762955,1683763950,995,14223,Southwest Airlines,MKE,SFO
SW109,1683782154,1683783529,1375,17919,Southwest Airlines,SFO,LAX
SW109,1683808944,1683810458,1514,18767,Southwest Airlines,LAX,SFO
SW109,1683839260,1683840809,1549,11499,Southwest Airlines,SFO,LAX
SW109,1683854010,1683854224,214,14939,Southwest Airlines,LAX,SFO
SW109,1683873512,1683879768,6256,11755,Southwest Airlines,SFO,ORD
SW109,1683898232,1683899914,1682,8636,Southwest Airlines,ORD,MKE
SW109,1683913754,1683918329,4575,5345,Southwest Airlines,MKE,ORD
SW109,1683925390,1683925725,335,14303,Southwest Airlines,ORD,MKE
SW109,1683940522,1683943248,2726,8809,Southwest Airlines,MKE,ORD
SW109,1683962147,1683962473,326,18060,Southwest Airlines,ORD,MKE
SW109,1683985501,1683988956,3455,17382,Southwest Airlines,MKE,ORD
SW109,1684015044,1684015498,454,15162,Southwest Airlines,ORD,MKE
SW109,1684033264,1684034046,782,15214,Southwest Airlines,MKE,SFO
SW109,1684059471,1684067840,8369,5746,Southwest Airlines,SFO,ORD
SW109,1684074248,1684075430,1182,19226,Southwest Airlines,ORD,MKE
SW109,1684101999,1684102957,958,3937,Southwest Airlines,MKE,SFO
SW109,1684114613,1684115651,1038,9560,Southwest Airlines,SFO,LAX
SW109,1684130735,1684133728,2993,10503,Southwest Airlines,LAX,ORD
SW109,1684147028,1684147451,423,4603,Southwest Airlines,ORD,MKE
SW109,1684157124,1684157603,479,3642,Southwest Airlines,MKE,LAX
SW109,1684164921,1684165510,589,17648,Southwest Airlines,LAX,SFO
SW109,1684191796,1684192290,494,11353,Southwest Airlines,SFO,LAX
SW109,1684205434,1684212361,6927,6095,Southwest Airlines,LAX,ORD
SW109,1684228445,1684230224,1779,20983,Southwest Airlines,ORD,MKE
SW109,1684252211,1684258070,5859,6112,Southwest Airlines,MKE,ORD
SW109,1684267121,1684267588,467,15157,Southwest Airlines,ORD,MKE
SW109,1684284706,1684292858,8152,4277,Southwest Airlines,MKE,ORD
SW109,1684303952,1684304905,953,13959,Southwest Airlines,ORD,MKE
SW109,1684324808,1684329476,4668,16820,Southwest Airlines,MKE,ORD
SW109,1684350980,1684352320,1340,19535,Southwest Airlines,ORD,MKE
SW109,1684381737,1684390201,8464,13506,Southwest Airlines,MKE,ORD
SW109,1684410988,1684411216,228,13557,Southwest Airlines,ORD,MKE
SW109,1684426387,1684426567,180,20835,Southwest Airlines,MKE,LAX
SW109,1684447455,1684448823,1368,20574,Southwest Airlines,LAX,SFO
SW109,1684477484,1684478055,571,17024,Southwest Airlines,SFO,LAX
SW109,1684497923,1684501249,3326,5271,Southwest Airlines,LAX,ORD
SW109,1684507131,1684507776,645,4404,Southwest Airlines,ORD,MKE
SW109,1684518009,1684523920,5911,17840,Southwest Airlines,MKE,ORD
SW109,1684552003,1684552042,39,20344,Southwest Airlines,ORD,MKE
SW109,1684575534,1684577213,1679,7404,Southwest Airlines,MKE,SFO
SW109,1684591649,1684592807,1158,13632,Southwest Airlines,SFO,LAX
SW109,1684611991,1684613201,1210,11224,Southwest Airlines,LAX,SFO
SW109,1684627413,1684635065,7652,10526,Southwest Airlines,SFO,ORD
SW109,1684653211,1684654398,1187,17357,Southwest Airlines,ORD,MKE
SW109,1684680108,1684680137,29,18849,Southwest Airlines,MKE,LAX
SW109,1684705624,1684710520,4896,14190,Southwest Airlines,LAX,ORD
SW109,1684728469,1684730222,1753,11708,Southwest Airlines,ORD,MKE
SW109,1684745414,1684746601,1187,20602,Southwest Airlines,MKE,LAX
SW109,1684776465,1684776813,348,11100,Southwest Airlines,LAX,SFO
SW109,1684794311,1684794391,80,19492,Southwest Airlines,SFO,LAX
SW109,1684824054,1684828016,3962,19511,Southwest Airlines,LAX,ORD
SW109,1684855693,1684857274,1581,8341,Southwest Airlines,ORD,MKE
SW109,1684871352,1684872379,1027,12756,Southwest Airlines,MKE,LAX
SW109,1684885312,1684888769,3457,8359,Southwest Airlines,LAX,ORD
SW109,1684902523,1684904300,1777,9949,Southwest Airlines,ORD,MKE
SW109,1684919943,1684920991,1048,14101,Southwest Airlines,MKE,LAX
SW109,1684936902,1684941432,4530,15668,Southwest Airlines,LAX,ORD
SW109,1684966715,1684968023,1308,7863,Southwest Airlines,ORD,MKE
SW109,1684978345,1684986584,8239,5086,Southwest Airlines,MKE,ORD
SW109,1685000363,1685001742,1379,18273,Southwest Airlines,ORD,MKE
SW109,1685027376,1685031051,3675,14750,Southwest Airlines,MKE,ORD
SW109,1685050351,1685051089,738,4110,Southwest Airlines,ORD,MKE
SW109,1685062868,1685063873,1005,3680,Southwest Airlines,MKE,SFO
SW109,1685072805,1685076791,3986,7980,Southwest Airlines,SFO,ORD
SW109,1685089488,1685090270,782,9990,Southwest Airlines,ORD,MKE
SW109,1685103957,1685104325,368,18855,Southwest Airlines,MKE,LAX
SW109,1685123184,1685131698,8514,9505,Southwest Airlines,LAX,ORD
SW109,1685144129,1685145731,1602,11790,Southwest Airlines,ORD,MKE
SW109,1685166788,1685167926,1138,17873,Southwest Airlines,MKE,LAX
SW109,1685189920,1685191662,1742,20306,Southwest Airlines,LAX,SFO
SW109,1685221178,1685222755,1577,19050,Southwest Airlines,SFO,LAX
SW109,1685243489,1685243972,483,10863,Southwest Airlines,LAX,SFO
SW109,1685263093,1685263798,705,14680,Southwest Airlines,SFO,LAX
SW109,1685285546,1685285919,373,17629,Southwest Airlines,LAX,SFO
SW109,1685305445,1685306688,1243,6828,Southwest Airlines,SFO,LAX
SW109,1685322532,1685323189,657,6627,Southwest Airlines,LAX,SFO
SW109,1685335446,1685336814,1368,12742,Southwest Airlines,SFO,LAX
SW109,1685358974,1685360485,1511,20252,Southwest Airlines,LAX,SFO
SW109,1685384940,1685385510,570,15533,Southwest Airlines,SFO,LAX
SW109,1685404018,1685410765,6747,16243,Southwest Airlines,LAX,ORD
SW109,1685433428,1685434551,1123,19449,Southwest Airlines,ORD,MKE
SW109,1685454067,1685455174,1107,8770,Southwest Airlines,MKE,SFO
SW109,1685469980,1685477744,7764,12608,Southwest Airlines,SFO,ORD
SW109,1685495996,1685496798,802,15512,Southwest Airlines,ORD,MKE
SW109,1685515752,1685517439,1687,18401,Southwest Airlines,MKE,SFO
SW109,1685544023,1685552195,8172,6079,Southwest Airlines,SFO,ORD
SW109,1685564867,1685566138,1271,13593,Southwest Airlines,ORD,MKE
SW109,1685589347,1685595870,6523,18203,Southwest Airlines,MKE,ORD
SW109,1685617953,1685618410,457,10319,Southwest Airlines,ORD,MKE
SW109,1685634824,1685635881,1057,6350,Southwest Airlines,MKE,SFO
SW109,1685647439,1685649663,2224,12948,Southwest Airlines,SFO,ORD
SW109,1685663542,1685663693,151,7476,Southwest Airlines,ORD,MKE
SW109,1685676838,1685677044,206,10236,Southwest Airlines,MKE,LAX
SW109,1685691009,1685695433,4424,5343,Southwest Airlines,LAX,ORD
SW109,1685710943,1685712270,1327,12011,Southwest Airlines,ORD,MKE
SW109,1685730300,1685730322,22,12305,Southwest Airlines,MKE,LAX
SW109,1685748686,1685753326,4640,4075,Southwest Airlines,LAX,ORD
SW109,1685768197,1685768228,31,16940,Southwest Airlines,ORD,MKE
SW109,1685788233,1685793750,5517,9670,Southwest Airlines,MKE,ORD
SW109,1685804218,1685804355,137,17639,Southwest Airlines,ORD,MKE
SW109,1685832566,1685837083,4517,16833,Southwest Airlines,MKE,ORD
SW109,1685857174,1685857826,652,16862,Southwest Airlines,ORD,MKE
SW109,1685876050,1685885643,9593,13557,Southwest Airlines,MKE,ORD
SW109,1685904504,1685904889,385,15064,Southwest Airlines,ORD,MKE
SW109,1685925680,1685932888,7208,4004,Southwest Airlines,MKE,ORD
SW109,1685944001,1685945670,1669,19761,Southwest Airlines,ORD,MKE
SW109,1685968098,1685977592,9494,6062,Southwest Airlines,MKE,ORD
SW109,1685984467,1685985937,1470,4952,Southwest Airlines,ORD,MKE
SW109,1686000709,1686009350,8641,7197,Southwest Airlines,MKE,ORD
SW109,1686019228,1686020868,1640,18470,Southwest Airlines,ORD,MKE
SW109,1686049788,1686054696,4908,21192,Southwest Airlines,MKE,ORD
SW109,1686083985,1686084392,407,18910,Southwest Airlines,ORD,MKE
SW109,1686109877,1686112088,2211,10289,Southwest Airlines,MKE,ORD
SW109,1686126745,1686126771,26,7616,Southwest Airlines,ORD,MKE
SW109,1686140707,1686145047,4340,5797,Southwest Airlines,MKE,ORD
SW109,1686158736,1686159600,864,8455,Southwest Airlines,ORD,MKE
SW109,1686177856,1686179429,1573,20366,Southwest Airlines,MKE,LAX
SW109,1686209126,1686209204,78,11849,Southwest Airlines,LAX,SFO
SW109,1686222652,1686226260,3608,15138,Southwest Airlines,SFO,ORD
SW109,1686249080,1686249845,765,15645,Southwest Airlines,ORD,MKE
SW109,1686268172,1686269628,1456,15513,Southwest Airlines,MKE,SFO
SW109,1686289204,1686290418,1214,11188,Southwest Airlines,SFO,LAX
SW109,1686304479,1686310735,6256,17799,Southwest Airlines,LAX,ORD
SW109,1686335250,1686335736,486,10394,Southwest Airlines,ORD,MKE
SW109,1686352868,1686359312,6444,8288,Southwest Airlines,MKE,ORD
SW109,1686374426,1686376092,1666,9568,Southwest Airlines,ORD,MKE
SW109,1686392367,1686392847,480,9844,Southwest Airlines,MKE,LAX
SW109,1686412501,1686420769,8268,17069,Southwest Airlines,LAX,ORD
SW109,1686441343,1686443066,1723,9972,Southwest Airlines,ORD,MKE
SW109,1686454906,1686456103,1197,13299,Southwest Airlines,MKE,SFO
SW109,1686473471,1686482296,8825,13213,Southwest Airlines,SFO,ORD
SW109,1686500224,1686501566,1342,19079,Southwest Airlines,ORD,MKE
SW109,1686524837,1686526282,1445,9002,Southwest Airlines,MKE,SFO
SW109,1686543383,1686552606,9223,5732,Southwest Airlines,SFO,ORD
SW109,1686562291,1686562837,546,18257,Southwest Airlines,ORD,MKE
SW109,1686590858,1686592606,1748,8262,Southwest Airlines,MKE,LAX
SW109,1686609634,1686610595,961,5609,Southwest Airlines,LAX,SFO
SW109,1686626623,1686634298,7675,10177,Southwest Airlines,SFO,ORD
SW109,1686649946,1686651525,1579,5935,Southwest Airlines,ORD,MKE
SW109,1686665977,1686666240,263,20451,Southwest Airlines,MKE,LAX
SW109,1686692552,1686692627,75,7132,Southwest Airlines,LAX,SFO
SW109,1686700713,1686711313,10600,13079,Southwest Airlines,SFO,ORD
SW109,1686727534,1686727588,54,15899,Southwest Airlines,ORD,MKE
SW109,1686750569,1686754075,3506,10742,Southwest Airlines,MKE,ORD
SW109,1686770181,1686770414,233,8063,Southwest Airlines,ORD,MKE
SW109,1686787356,1686788914,1558,10695,Southwest Airlines,MKE,SFO
SW109,1686805511,1686808782,3271,11370,Southwest Airlines,SFO,ORD
SW109,1686829745,1686830459,714,13108,Southwest Airlines,ORD,MKE
SW109,1686853629,1686858583,4954,14483,Southwest Airlines,MKE,ORD
SW109,1686879971,1686880858,887,14695,Southwest Airlines,ORD,MKE
SW109,1686900110,1686900400,290,18961,Southwest Airlines,MKE,SFO
SW109,1686923477,1686925359,1882,3973,Southwest Airlines,SFO,ORD
SW109,1686939181,1686939748,567,5182,Southwest Airlines,ORD,MKE
SW109,1686955163,1686958541,3378,7324,Southwest Airlines,MKE,ORD
SW109,1686966458,1686966723,265,15908,Southwest Airlines,ORD,MKE
SW109,1686984541,1686984860,319,6051,Southwest Airlines,MKE,SFO
SW109,1686995204,1686998592,3388,5557,Southwest Airlines,SFO,ORD
SW109,1687005120,1687005843,723,8527,Southwest Airlines,ORD,MKE
SW109,1687021407,1687031654,10247,14177,Southwest Airlines,MKE,ORD
SW109,1687048833,1687049432,599,15167,Southwest Airlines,ORD,MKE
SW109,1687071920,1687081475,9555,10684,Southwest Airlines,MKE,ORD
SW109,1687102632,1687102926,294,4249,Southwest Airlines,ORD,MKE
SW109,1687111969,1687118914,6945,9519,Southwest Airlines,MKE,ORD
SW109,1687136071,1687137432,1361,6162,Southwest Airlines,ORD,MKE
SW109,1687147960,1687151300,3340,7847,Southwest Airlines,MKE,ORD
SW109,1687161599,1687161798,199,4036,Southwest Airlines,ORD,MKE
SW109,1687171800,1687174286,2486,17871,Southwest Airlines,MKE,ORD
SW109,1687201924,1687203713,1789,4411,Southwest Airlines,ORD,MKE
SW109,1687212990,1687220917,7927,15747,Southwest Airlines,MKE,ORD
SW109,1687242371,1687242823,452,19700,Southwest Airlines,ORD,MKE
SW109,1687266240,1687272598,6358,15018,Southwest Airlines,MKE,ORD
SW109,1687296477,1687297843,1366,7368,Southwest Airlines,ORD,MKE
SW109,1687313363,1687313791,428,20036,Southwest Airlines,MKE,LAX
SW109,1687341438,1687344142,2704,13586,Southwest Airlines,LAX,ORD
SW109,1687358491,1687358594,103,5489,Southwest Airlines,ORD,MKE
SW109,1687370239,1687370495,256,7023,Southwest Airlines,MKE,LAX
SW109,1687387807,1687388849,1042,3823,Southwest Airlines,LAX,SFO
SW109,1687398713,1687399422,709,17060,Southwest Airlines,SFO,LAX
SW109,1687426912,1687427691,779,13001,Southwest Airlines,LAX,SFO
SW109,1687448292,1687449818,1526,10087,Southwest Airlines,SFO,LAX
SW109,1687463274,1687467561,4287,11246,Southwest Airlines,LAX,ORD
SW109,1687479527,1687479602,75,7566,Southwest Airlines,ORD,MKE
SW109,1687489328,1687489468,140,7608,Southwest Airlines,MKE,LAX
SW109,1687501939,1687507909,5970,8330,Southwest Airlines,LAX,ORD
SW109,1687524446,1687524527,81,10489,Southwest Airlines,ORD,MKE
SW109,1687542969,1687544109,1140,10096,Southwest Airlines,MKE,LAX
SW109,1687564250,1687568344,4094,7615,Southwest Airlines,LAX,ORD
SW109,1687580647,1687581499,852,20748,Southwest Airlines,ORD,MKE
SW109,1687609400,1687614330,4930,11808,Southwest Airlines,MKE,ORD
SW109,1687626502,1687626641,139,10843,Southwest Airlines,ORD,MKE
SW109,1687643381,1687645125,1744,16235,Southwest Airlines,MKE,SFO
SW109,1687670782,1687677503,6721,20988,Southwest Airlines,SFO,ORD
SW109,1687706466,1687707004,538,15043,Southwest Airlines,ORD,MKE
SW109,1687728906,1687730393,1487,5769,Southwest Airlines,MKE,SFO
SW109,1687737290,1687738518,1228,3713,Southwest Airlines,SFO,LAX
SW109,1687745358,1687755882,10524,19502,Southwest Airlines,LAX,ORD
SW109,1687780497,1687781846,1349,6497,Southwest Airlines,ORD,MKE
SW109,1687790216,1687798070,7854,5443,Southwest Airlines,MKE,ORD
SW109,1687807790,1687807933,143,20097,Southwest Airlines,ORD,MKE
SW109,1687833210,1687838679,5469,8044,Southwest Airlines,MKE,ORD
SW109,1687856588,1687857822,1234,7811,Southwest Airlines,ORD,MKE
SW109,1687872401,1687873421,1020,6193,Southwest Airlines,MKE,SFO
SW109,1687885815,1687887520,1705,18974,Southwest Airlines,SFO,LAX
SW109,1687906962,1687917697,10735,4386,Southwest Airlines,LAX,ORD
SW109,1687932626,1687933367,741,7876,Southwest Airlines,ORD,MKE
SW109,1687947649,1687948091,442,9868,Southwest Airlines,MKE,SFO
SW109,1687965118,1687974409,9291,13271,Southwest Airlines,SFO,ORD
SW109,1687995597,1687996325,728,8705,Southwest Airlines,ORD,MKE
SW109,1688014650,1688020832,6182,13646,Southwest Airlines,MKE,ORD
SW109,1688036156,1688037188,1032,4245,Southwest Airlines,ORD,MKE
SW109,1688047294,1688047450,156,7393,Southwest Airlines,MKE,SFO
SW109,1688060862,1688064369,3507,13566,Southwest Airlines,SFO,ORD
SW109,1688084605,1688085478,873,16395,Southwest Airlines,ORD,MKE
SW109,1688104121,1688104666,545,9121,Southwest Airlines,MKE,SFO
SW109,1688124286,1688130909,6623,15425,Southwest Airlines,SFO,ORD
SW109,1688153922,1688154011,89,5869,Southwest Airlines,ORD,MKE
SW109,1688162164,1688163210,1046,10093,Southwest Airlines,MKE,LAX
SW109,1688178412,1688179836,1424,15916,Southwest Airlines,LAX,SFO
SW109,1688201900,1688206677,4777,12557,Southwest Airlines,SFO,ORD
SW109,1688220897,1688222405,1508,17395,Southwest Airlines,ORD,MKE
SW109,1688244636,1688244886,250,17879,Southwest Airlines,MKE,SFO
SW109,1688267434,1688268161,727,12788,Southwest Airlines,SFO,LAX
SW109,1688289224,1688299192,9968,18695,Southwest Airlines,LAX,ORD
SW109,1688317921,1688318663,742,16363,Southwest Airlines,ORD,MKE
SW109,1688342371,1688348330,5959,20103,Southwest Airlines,MKE,ORD
SW109,1688376908,1688376987,79,11860,Southwest Airlines,ORD,MKE
SW109,1688394965,1688395179,214,19561,Southwest Airlines,MKE,LAX
SW109,1688416237,1688417800,1563,9193,Southwest Airlines,LAX,SFO
SW109,1688429409,1688429544,135,5140,Southwest Airlines,SFO,LAX
SW109,1688436714,1688444569,7855,19876,Southwest Airlines,LAX,ORD
SW109,1688467481,1688467778,297,16260,Southwest Airlines,ORD,MKE
SW109,1688486354,1688496102,9748,19273,Southwest Airlines,MKE,ORD
SW109,1688522464,1688524237,1773,20695,Southwest Airlines,ORD,MKE
SW109,1688554856,1688554858,2,18024,Southwest Airlines,MKE,SFO
SW109,1688578006,1688583204,5198,21365,Southwest Airlines,SFO,ORD
SW109,1688614237,1688615381,1144,9660,Southwest Airlines,ORD,MKE
SW109,1688634992,1688635724,732,11090,Southwest Airlines,MKE,SFO
SW109,1688650137,1688656466,6329,13425,Southwest Airlines,SFO,ORD
SW109,1688680375,1688680396,21,5028,Southwest Airlines,ORD,MKE
SW109,1688688593,1688697661,9068,21364,Southwest Airlines,MKE,ORD
SW109,1688721682,1688722368,686,21184,Southwest Airlines,ORD,MKE
SW109,1688744977,1688750686,5709,16489,Southwest Airlines,MKE,ORD
SW109,1688773562,1688774555,993,8469,Southwest Airlines,ORD,MKE
SW109,1688784172,1688785514,1342,16493,Southwest Airlines,MKE,LAX
SW109,1688809064,1688810822,1758,9667,Southwest Airlines,LAX,SFO
SW109,1688822619,1688831827,9208,17880,Southwest Airlines,SFO,ORD
SW109,1688859696,1688861132,1436,18139,Southwest Airlines,ORD,MKE
SW109,1688880264,1688888936,8672,19218,Southwest Airlines,MKE,ORD
SW109,1688908580,1688910153,1573,12534,Southwest Airlines,ORD,MKE
SW109,1688928412,1688938651,10239,8090,Southwest Airlines,MKE,ORD
SW109,1688951107,1688952673,1566,13968,Southwest Airlines,ORD,MKE
SW109,1688971640,1688973409,1769,5900,Southwest Airlines,MKE,LAX
SW109,1688980633,1688981848,1215,12478,Southwest Airlines,LAX,SFO
SW109,1688999874,1689000321,447,11255,Southwest Airlines,SFO,LAX
SW109,1689014345,1689021453,7108,10891,Southwest Airlines,LAX,ORD
SW109,1689034723,1689036522,1799,19471,Southwest Airlines,ORD,MKE
SW109,1689056643,1689058437,1794,10486,Southwest Airlines,MKE,SFO
SW109,1689070097,1689071885,1788,16612,Southwest Airlines,SFO,LAX
SW109,1689097772,1689101841,4069,19766,Southwest Airlines,LAX,ORD
SW109,1689125198,1689125511,313,12627,Southwest Airlines,ORD,MKE
SW109,1689148556,1689149799,1243,9973,Southwest Airlines,MKE,LAX
SW109,1689160055,1689168333,8278,9524,Southwest Airlines,LAX,ORD
SW109,1689183752,1689184632,880,7301,Southwest Airlines,ORD,MKE
SW109,1689202717,1689207058,4341,6650,Southwest Airlines,MKE,ORD
SW109,1689218469,1689219430,961,8952,Southwest Airlines,ORD,MKE
SW109,1689229531,1689229673,142,15780,Southwest Airlines,MKE,SFO
SW109,1689254587,1689255055,468,4522,Southwest Airlines,SFO,LAX
SW109,1689265136,1689271050,5914,15631,Southwest Airlines,LAX,ORD
SW109,1689293769,1689295203,1434,18885,Southwest Airlines,ORD,MKE
SW109,1689324316,1689326028,1712,13472,Southwest Airlines,MKE,SFO
SW109,1689348963,1689350311,1348,3830,Southwest Airlines,SFO,LAX
SW109,1689359663,1689360544,881,12426,Southwest Airlines,LAX,SFO
SW109,1689377541,1689378107,566,11047,Southwest Airlines,SFO,LAX
SW109,1689392801,1689399769,6968,17539,Southwest Airlines,LAX,ORD
SW109,1689427242,1689428768,1526,13195,Southwest Airlines,ORD,MKE
SW109,1689451320,1689456476,5156,20388,Southwest Airlines,MKE,ORD
SW109,1689482300,1689482615,315,10908,Southwest Airlines,ORD,MKE
SW109,1689494129,1689495865,1736,9368,Southwest Airlines,MKE,LAX
SW109,1689513256,1689522674,9418,14322,Southwest Airlines,LAX,ORD
SW109,1689540160,1689540188,28,9511,Southwest Airlines,ORD,MKE
SW109,1689558938,1689559465,527,5432,Southwest Airlines,MKE,LAX
SW109,1689572921,1689583695,10774,4971,Southwest Airlines,LAX,ORD
SW109,1689596273,1689596349,76,5310,Southwest Airlines,ORD,MKE
SW109,1689606083,1689607602,1519,6179,Southwest Airlines,MKE,LAX
SW109,1689615742,1689625627,9885,7144,Southwest Airlines,LAX,ORD
SW109,1689634962,1689635077,115,11419,Southwest Airlines,ORD,MKE
SW109,1689647080,1689647273,193,19387,Southwest Airlines,MKE,LAX
SW109,1689671120,1689672101,981,13154,Southwest Airlines,LAX,SFO
SW109,1689693512,1689693516,4,4250,Southwest Airlines,SFO,LAX
SW109,1689700645,1689709716,9071,5149,Southwest Airlines,LAX,ORD
SW109,1689720579,1689721047,468,14861,Southwest Airlines,ORD,MKE
SW109,1689743017,1689743893,876,15542,Southwest Airlines,MKE,SFO
SW109,1689759711,1689760184,473,16838,Southwest Airlines,SFO,LAX
SW109,1689785306,1689795277,9971,18746,Southwest Airlines,LAX,ORD
SW109,1689823253,1689824973,1720,20115,Southwest Airlines,ORD,MKE
SW109,1689853836,1689857065,3229,10469,Southwest Airlines,MKE,ORD
SW109,1689877759,1689878680,921,12221,Southwest Airlines,ORD,MKE
SW109,1689890930,1689892188,1258,16536,Southwest Airlines,MKE,LAX
SW109,1689918154,1689919671,1517,5708,Southwest Airlines,LAX,SFO
SW109,1689927947,1689929600,1653,7570,Southwest Airlines,SFO,LAX
SW109,1689943911,1689944458,547,3885,Southwest Airlines,LAX,SFO
SW109,1689950689,1689952223,1534,18879,Southwest Airlines,SFO,LAX
SW109,1689975466,1689978235,2769,10102,Southwest Airlines,LAX,ORD
SW109,1689989508,1689990812,1304,17786,Southwest Airlines,ORD,MKE
SW109,1690016150,1690016688,538,16837,Southwest Airlines,MKE,SFO
SW109,1690034544,1690035226,682,4058,Southwest Airlines,SFO,LAX
SW109,1690046449,1690046548,99,4421,Southwest Airlines,LAX,SFO
SW109,1690052554,1690058260,5706,11515,Southwest Airlines,SFO,ORD
SW109,1690070673,1690072235,1562,21582,Southwest Airlines,ORD,MKE
SW109,1690094334,1690094657,323,14343,Southwest Airlines,MKE,SFO
SW109,1690117265,1690117791,526,12171,Southwest Airlines,SFO,LAX
SW109,1690133010,1690136457,3447,16679,Southwest Airlines,LAX,ORD
SW109,1690157672,1690158015,343,8813,Southwest Airlines,ORD,MKE
SW109,1690170363,1690171673,1310,16973,Southwest Airlines,MKE,SFO
SW109,1690196807,1690197804,997,5592,Southwest Airlines,SFO,LAX
SW109,1690206746,1690210912,4166,10301,Southwest Airlines,LAX,ORD
SW109,1690229959,1690230996,1037,20663,Southwest Airlines,ORD,MKE
SW109,1690257020,1690257772,752,18820,Southwest Airlines,MKE,SFO
SW109,1690285203,1690291462,6259,15528,Southwest Airlines,SFO,ORD
SW109,1690307500,1690309258,1758,8073,Southwest Airlines,ORD,MKE
SW109,1690320740,1690330560,9820,11005,Southwest Airlines,MKE,ORD
SW109,1690344326,1690344823,497,8494,Southwest Airlines,ORD,MKE
SW109,1690360839,1690361847,1008,16695,Southwest Airlines,MKE,SFO
SW109,1690381351,1690382710,1359,17548,Southwest Airlines,SFO,LAX
SW109,1690401595,1690402495,900,13010,Southwest Airlines,LAX,SFO
SW109,1690422854,1690426751,3897,6421,Southwest Airlines,SFO,ORD
SW109,1690434400,1690435233,833,7188,Southwest Airlines,ORD,MKE
SW109,1690443305,1690445086,1781,11883,Southwest Airlines,MKE,LAX
SW109,1690467076,1690476864,9788,14193,Southwest Airlines,LAX,ORD
SW109,1690494442,1690495786,1344,3814,Southwest Airlines,ORD,MKE
SW109,1690502194,1690504456,2262,3897,Southwest Airlines,MKE,ORD
SW109,1690514833,1690515235,402,10005,Southwest Airlines,ORD,MKE
SW109,1690528946,1690538213,9267,4444,Southwest Airlines,MKE,ORD
SW109,1690544122,1690544524,402,8629,Southwest Airlines,ORD,MKE
SW109,1690561814,1690562642,828,15444,Southwest Airlines,MKE,SFO
SW109,1690580378,1690581093,715,5277,Southwest Airlines,SFO,LAX
SW109,1690595651,1690596933,1282,4362,Southwest Airlines,LAX,SFO
SW109,1690610184,1690611615,1431,14863,Southwest Airlines,SFO,LAX
SW109,1690626753,1690632348,5595,5250,Southwest Airlines,LAX,ORD
SW109,1690642785,1690644290,1505,9511,Southwest Airlines,ORD,MKE
SW109,1690661063,1690661434,371,15642,Southwest Airlines,MKE,LAX
SW109,1690684606,1690685054,448,4005,Southwest Airlines,LAX,SFO
SW109,1690693034,1690693477,443,9310,Southwest Airlines,SFO,LAX
SW109,1690705807,1690712070,6263,18379,Southwest Airlines,LAX,ORD
SW109,1690738875,1690740595,1720,8824,Southwest Airlines,ORD,MKE
SW109,1690758004,1690758380,376,16923,Southwest Airlines,MKE,SFO
SW109,1690781194,1690791518,10324,13992,Southwest Airlines,SFO,ORD
SW109,1690815400,1690815670,270,9983,Southwest Airlines,ORD,MKE
SW109,1690834216,1690835234,1018,20427,Southwest Airlines,MKE,SFO
SW109,1690860569,1690866575,6006,9219,Southwest Airlines,SFO,ORD
SW109,1690880531,1690881650,1119,9357,Southwest Airlines,ORD,MKE
SW109,1690894983,1690896531,1548,16325,Southwest Airlines,MKE,LAX
SW109,1690920534,1690921542,1008,21320,Southwest Airlines,LAX,SFO
SW109,1690949965,1690950417,452,14316,Southwest Airlines,SFO,LAX
SW109,1690972514,1690972627,113,8188,Southwest Airlines,LAX,SFO
SW109,1690982691,1690993288,10597,13654,Southwest Airlines,SFO,ORD
SW109,1691016476,1691017617,1141,11360,Southwest Airlines,ORD,MKE
SW109,1691035245,1691035448,203,3963,Southwest Airlines,MKE,SFO
SW109,1691040729,1691041726,997,15690,Southwest Airlines,SFO,LAX
SW109,1691065596,1691075076,9480,12489,Southwest Airlines,LAX,ORD
SW109,1691090646,1691091184,538,9124,Southwest Airlines,ORD,MKE
SW109,1691107018,1691108096,1078,15280,Southwest Airlines,MKE,SFO
SW109,1691133520,1691138718,5198,10246,Southwest Airlines,SFO,ORD
SW109,1691157050,1691157185,135,15651,Southwest Airlines,ORD,MKE
SW109,1691177358,1691179124,1766,20061,Southwest Airlines,MKE,SFO
SW109,1691206547,1691209130,2583,10661,Southwest Airlines,SFO,ORD
SW109,1691224945,1691225771,826,11990,Southwest Airlines,ORD,MKE
SW109,1691247643,1691248126,483,14343,Southwest Airlines,MKE,LAX
SW109,1691270627,1691276293,5666,8016,Southwest Airlines,LAX,ORD
SW109,1691285098,1691285287,189,18235,Southwest Airlines,ORD,MKE
SW109,1691304400,1691305601,1201,21145,Southwest Airlines,MKE,LAX
SW109,1691331394,1691334391,2997,6759,Southwest Airlines,LAX,ORD
SW109,1691348793,1691349211,418,17137,Southwest Airlines,ORD,MKE
SW109,1691375769,1691377534,1765,9658,Southwest Airlines,MKE,SFO
SW109,1691389427,1691398677,9250,8642,Southwest Airlines,SFO,ORD
SW109,1691411313,1691411949,636,6639,Southwest Airlines,ORD,MKE
SW109,1691423164,1691429812,6648,16168,Southwest Airlines,MKE,ORD
SW109,1691452198,1691453095,897,4268,Southwest Airlines,ORD,MKE
SW109,1691458520,1691459761,1241,15928,Southwest Airlines,MKE,SFO
SW109,1691479383,1691479995,612,10980,Southwest Airlines,SFO,LAX
SW109,1691494301,1691495492,1191,11761,Southwest Airlines,LAX,SFO
SW109,1691513219,1691522295,9076,6611,Southwest Airlines,SFO,ORD
SW109,1691538121,1691539510,1389,6124,Southwest Airlines,ORD,MKE
SW109,1691556106,1691563450,7344,11630,Southwest Airlines,MKE,ORD
SW109,1691583001,1691583016,15,7582,Southwest Airlines,ORD,MKE
SW109,1691595695,1691596317,622,18976,Southwest Airlines,MKE,LAX
SW109,1691621549,1691621711,162,11216,Southwest Airlines,LAX,SFO
SW109,1691634840,1691636240,1400,8491,Southwest Airlines,SFO,LAX
SW109,1691652125,1691653882,1757,19213,Southwest Airlines,LAX,SFO
SW109,1691683333,1691684814,1481,10937,Southwest Airlines,SFO,LAX
SW109,1691696788,1691703543,6755,4482,Southwest Airlines,LAX,ORD
SW109,1691714462,1691715912,1450,7447,Southwest Airlines,ORD,MKE
SW109,1691725278,1691726248,970,9522,Southwest Airlines,MKE,LAX
SW109,1691739482,1691747563,8081,4712,Southwest Airlines,LAX,ORD
SW109,1691753035,1691753700,665,13255,Southwest Airlines,ORD,MKE
SW109,1691770980,1691772554,1574,7634,Southwest Airlines,MKE,SFO
SW109,1691785414,1691796199,10785,12850,Southwest Airlines,SFO,ORD
SW109,1691811315,1691811620,305,17116,Southwest Airlines,ORD,MKE
SW109,1691836660,1691836922,262,21512,Southwest Airlines,MKE,SFO
SW109,1691868996,1691870114,1118,11105,Southwest Airlines,SFO,LAX
SW109,1691888960,1691894219,5259,21078,Southwest Airlines,LAX,ORD
SW109,1691924366,1691925460,1094,19878,Southwest Airlines,ORD,MKE
SW109,1691948805,1691950020,1215,6793,Southwest Airlines,MKE,SFO
SW109,1691964825,1691966297,1472,6345,Southwest Airlines,SFO,LAX
SW109,1691980425,1691982253,1828,12767,Southwest Airlines,LAX,ORD
SW109,1691996588,1691997695,1107,8956,Southwest Airlines,ORD,MKE
SW109,1692007040,1692007430,390,9912,Southwest Airlines,MKE,LAX
SW109,1692020164,1692021878,1714,16760,Southwest Airlines,LAX,SFO
SW109,1692040295,1692049724,9429,8215,Southwest Airlines,SFO,ORD
SW109,1692064680,1692066083,1403,15229,Southwest Airlines,ORD,MKE
SW109,1692085274,1692086213,939,8193,Southwest Airlines,MKE,LAX
SW109,1692096847,1692104667,7820,20438,Southwest Airlines,LAX,ORD
SW109,1692128786,1692128910,124,11301,Southwest Airlines,ORD,MKE
SW109,1692150150,1692150899,749,18023,Southwest Airlines,MKE,LAX
SW109,1692175378,1692176676,1298,8329,Southwest Airlines,LAX,SFO
SW109,1692188935,1692190011,1076,20052,Southwest Airlines,SFO,LAX
SW109,1692210773,1692218030,7257,10079,Southwest Airlines,LAX,ORD
SW109,1692236365,1692237755,1390,6031,Southwest Airlines,ORD,MKE
SW109,1692246614,1692248266,1652,8543,Southwest Airlines,MKE,LAX
SW109,1692259033,1692259119,86,21306,Southwest Airlines,LAX,SFO
SW109,1692285156,1692285228,72,9821,Southwest Airlines,SFO,LAX
SW109,1692297605,1692302108,4503,15666,Southwest Airlines,LAX,ORD
SW109,1692321741,1692323335,1594,21035,Southwest Airlines,ORD,MKE
SW109,1692346997,1692352343,5346,9711,Southwest Airlines,MKE,ORD
SW109,1692372578,1692373627,1049,17893,Southwest Airlines,ORD,MKE
SW109,1692399803,1692409364,9561,17782,Southwest Airlines,MKE,ORD
SW109,1692433261,1692433636,375,9770,Southwest Airlines,ORD,MKE
SW109,1692450187,1692451678,1491,21243,Southwest Airlines,MKE,SFO
SW109,1692479816,1692480245,429,18608,Southwest Airlines,SFO,LAX
SW109,1692507517,1692508985,1468,5751,Southwest Airlines,LAX,SFO
SW109,1692524499,1692524629,130,14913,Southwest Airlines,SFO,LAX
SW109,1692549016,1692549295,279,18201,Southwest Airlines,LAX,SFO
SW109,1692569338,1692570734,1396,19064,Southwest Airlines,SFO,LAX
SW109,1692590847,1692592206,1359,6686,Southwest Airlines,LAX,SFO
SW109,1692602870,1692612019,9149,9198,Southwest Airlines,SFO,ORD
SW109,1692630753,1692632117,1364,10302,Southwest Airlines,ORD,MKE
SW109,1692652188,1692653779,1591,20424,Southwest Airlines,MKE,LAX
SW109,1692678595,1692678797,202,10096,Southwest Airlines,LAX,SFO
SW109,1692693206,1692693279,73,16257,Southwest Airlines,SFO,LAX
SW109,1692711199,1692711831,632,20132,Southwest Airlines,LAX,SFO
SW109,1692733046,1692734567,1521,12569,Southwest Airlines,SFO,LAX
SW109,1692751755,1692753051,1296,20667,Southwest Airlines,LAX,SFO
SW109,1692777210,1692777642,432,4732,Southwest Airlines,SFO,LAX
SW109,1692784116,1692785654,1538,19797,Southwest Airlines,LAX,SFO
SW109,1692815456,1692815965,509,20194,Southwest Airlines,SFO,LAX
SW109,1692846138,1692851530,5392,20382,Southwest Airlines,LAX,ORD
SW109,1692878701,1692879114,413,10328,Southwest Airlines,ORD,MKE
SW109,1692898570,1692899731,1161,11845,Southwest Airlines,MKE,SFO
SW109,1692912859,1692917563,4704,8083,Southwest Airlines,SFO,ORD
SW109,1692931119,1692932067,948,16633,Southwest Airlines,ORD,MKE
SW109,1692952104,1692952584,480,16770,Southwest Airlines,MKE,SFO
SW109,1692973252,1692981047,7795,13472,Southwest Airlines,SFO,ORD
SW109,1692995824,1692996001,177,17131,Southwest Airlines,ORD,MKE
SW109,1693022529,1693023210,681,15761,Southwest Airlines,MKE,SFO
SW109,1693044727,1693045024,297,5886,Southwest Airlines,SFO,LAX
SW109,1693053824,1693058489,4665,12825,Southwest Airlines,LAX,ORD
SW109,1693075945,1693076219,274,4814,Southwest Airlines,ORD,MKE
SW109,1693087923,1693097258,9335,20413,Southwest Airlines,MKE,ORD
SW109,1693124426,1693125272,846,10409,Southwest Airlines,ORD,MKE
SW109,1693145505,1693145868,363,10436,Southwest Airlines,MKE,SFO
SW109,1693165000,1693174726,9726,6923,Southwest Airlines,SFO,ORD
SW109,1693188204,1693188768,564,6555,Southwest Airlines,ORD,MKE
SW109,1693205087,1693206710,1623,8228,Southwest Airlines,MKE,SFO
SW109,1693216894,1693221926,5032,9362,Southwest Airlines,SFO,ORD
SW109,1693241517,1693242253,736,16768,Southwest Airlines,ORD,MKE
SW109,1693264261,1693265635,1374,9276,Southwest Airlines,MKE,SFO
SW109,1693281251,1693282760,1509,17140,Southwest Airlines,SFO,LAX
SW109,1693305824,1693311997,6173,18207,Southwest Airlines,LAX,ORD
SW109,1693333026,1693333903,877,6840,Southwest Airlines,ORD,MKE
SW109,1693345196,1693346379,1183,6617,Southwest Airlines,MKE,SFO
SW109,1693361157,1693371929,10772,11626,Southwest Airlines,SFO,ORD
SW109,1693393278,1693394107,829,3871,Southwest Airlines,ORD,MKE
SW109,1693403450,1693403614,164,11655,Southwest Airlines,MKE,LAX
SW109,1693423824,1693425141,1317,5921,Southwest Airlines,LAX,SFO
SW109,1693439839,1693440447,608,16856,Southwest Airlines,SFO,LAX
SW109,1693458614,1693466887,8273,7152,Southwest Airlines,LAX,ORD
SW109,1693474789,1693476559,1770,17483,Southwest Airlines,ORD,MKE
SW109,1693500241,1693501659,1418,17228,Southwest Airlines,MKE,SFO
SW109,1693524054,1693532228,8174,21122,Southwest Airlines,SFO,ORD
SW109,1693555421,1693555958,537,11458,Southwest Airlines,ORD,MKE
SW109,1693567901,1693569558,1657,6426,Southwest Airlines,MKE,SFO
SW109,1693584044,1693594525,10481,17597,Southwest Airlines,SFO,ORD
SW109,1693613430,1693614570,1140,18947,Southwest Airlines,ORD,MKE
SW109,1693634839,1693645055,10216,10792,Southwest Airlines,MKE,ORD
SW109,1693655937,1693657371,1434,6724,Southwest Airlines,ORD,MKE
SW109,1693668256,1693669589,1333,16148,Southwest Airlines,MKE,SFO
SW109,1693693119,1693702616,9497,10412,Southwest Airlines,SFO,ORD
SW109,1693722657,1693723593,936,9371,Southwest Airlines,ORD,MKE
SW109,1693741697,1693744782,3085,19432,Southwest Airlines,MKE,ORD
SW109,1693773677,1693774695,1018,20528,Southwest Airlines,ORD,MKE
SW109,1693799099,1693799476,377,6878,Southwest Airlines,MKE,SFO
SW109,1693816890,1693821055,4165,10457,Southwest Airlines,SFO,ORD
SW109,1693840228,1693841551,1323,15054,Southwest Airlines,ORD,MKE
SW109,1693861898,1693863028,1130,10354,Southwest Airlines,MKE,SFO
SW109,1693874974,1693875177,203,18944,Southwest Airlines,SFO,LAX
SW109,1693898416,1693898419,3,9283,Southwest Airlines,LAX,SFO
SW109,1693916170,1693916428,258,18171,Southwest Airlines,SFO,LAX
SW109,1693944120,1693945928,1808,8037,Southwest Airlines,LAX,ORD
SW109,1693957677,1693958960,1283,14696,Southwest Airlines,ORD,MKE
SW109,1693975256,1693975828,572,19945,Southwest Airlines,MKE,SFO
SW109,1694006248,1694007325,1077,15709,Southwest Airlines,SFO,LAX
SW109,1694029455,1694029703,248,21121,Southwest Airlines,LAX,SFO
SW109,1694052204,1694058189,5985,4767,Southwest Airlines,SFO,ORD
SW109,1694067359,1694068547,1188,3602,Southwest Airlines,ORD,MKE
SW109,1694080656,1694085242,4586,3695,Southwest Airlines,MKE,ORD
SW109,1694093577,1694095344,1767,9698,Southwest Airlines,ORD,MKE
SW109,1694110574,1694111171,597,14077,Southwest Airlines,MKE,SFO
SW109,1694129722,1694130482,760,11912,Southwest Airlines,SFO,LAX
SW109,1694149784,1694151757,1973,14695,Southwest Airlines,LAX,ORD
SW109,1694177184,1694177249,65,3636,Southwest Airlines,ORD,MKE
SW109,1694187360,1694187653,293,17146,Southwest Airlines,MKE,SFO
SW109,1694215587,1694224446,8859,16966,Southwest Airlines,SFO,ORD
SW109,1694243147,1694244702,1555,8139,Southwest Airlines,ORD,MKE
SW109,1694259756,1694260189,433,17290,Southwest Airlines,MKE,LAX
SW109,1694285701,1694288741,3040,9270,Southwest Airlines,LAX,ORD
SW109,1694302749,1694304289,1540,18056,Southwest Airlines,ORD,MKE
SW109,1694328029,1694328387,358,18414,Southwest Airlines,MKE,LAX
SW109,1694350847,1694353307,2460,10319,Southwest Airlines,LAX,ORD
SW109,1694365980,1694366830,850,18411,Southwest Airlines,ORD,MKE
SW109,1694390378,1694391342,964,4898,Southwest Airlines,MKE,SFO
SW109,1694403150,1694404531,1381,11421,Southwest Airlines,SFO,LAX
SW109,1694419520,1694420112,592,17766,Southwest Airlines,LAX,SFO
SW109,1694447937,1694448555,618,11796,Southwest Airlines,SFO,LAX
SW109,1694465464,1694467230,1766,18790,Southwest Airlines,LAX,SFO
SW109,1694489577,1694492224,2647,14743,Southwest Airlines,SFO,ORD
SW109,1694512625,1694514187,1562,15388,Southwest Airlines,ORD,MKE
SW109,1694535935,1694536799,864,7405,Southwest Airlines,MKE,SFO
SW109,1694552354,1694556301,3947,9784,Southwest Airlines,SFO,ORD
SW109,1694570819,1694572522,1703,4686,Southwest Airlines,ORD,MKE
SW109,1694587002,1694590836,3834,17146,Southwest Airlines,MKE,ORD
SW109,1694614964,1694615422,458,3974,Southwest Airlines,ORD,MKE
SW109,1694620056,1694620148,92,20005,Southwest Airlines,MKE,SFO
SW109,1694642856,1694643612,756,8188,Southwest Airlines,SFO,LAX
SW109,1694659603,1694661712,2109,15232,Southwest Airlines,LAX,ORD
SW109,1694678710,1694678869,159,9692,Southwest Airlines,ORD,MKE
SW109,1694697567,1694702292,4725,20035,Southwest Airlines,MKE,ORD
SW109,1694726706,1694727587,881,15829,Southwest Airlines,ORD,MKE
SW109,1694752331,1694752880,549,13611,Southwest Airlines,MKE,SFO
SW109,1694766524,1694773344,6820,4130,Southwest Airlines,SFO,ORD
SW109,1694782182,1694782903,721,20803,Southwest Airlines,ORD,MKE
SW109,1694810833,1694812121,1288,15149,Southwest Airlines,MKE,LAX
SW109,1694831765,1694838984,7219,17730,Southwest Airlines,LAX,ORD
SW109,1694867315,1694867537,222,11543,Southwest Airlines,ORD,MKE
SW109,1694883059,1694888939,5880,9481,Southwest Airlines,MKE,ORD
SW109,1694898758,1694900132,1374,15999,Southwest Airlines,ORD,MKE
SW109,1694922895,1694932871,9976,16100,Southwest Airlines,MKE,ORD
SW109,1694953779,1694954641,862,4697,Southwest Airlines,ORD,MKE
SW109,1694966729,1694972187,5458,6290,Southwest Airlines,MKE,ORD
SW109,1694986889,1694987474,585,21130,Southwest Airlines,ORD,MKE
SW109,1695011528,1695013306,1778,9364,Southwest Airlines,MKE,LAX
SW109,1695027291,1695037949,10658,7517,Southwest Airlines,LAX,ORD
SW109,1695050664,1695050886,222,5567,Southwest Airlines,ORD,MKE
SW109,1695061056,1695063945,2889,4310,Southwest Airlines,MKE,ORD
SW109,1695074599,1695075200,601,10472,Southwest Airlines,ORD,MKE
SW109,1695095466,1695097100,1634,5658,Southwest Airlines,MKE,LAX
SW109,1695105426,1695114828,9402,8095,Southwest Airlines,LAX,ORD
SW109,1695128972,1695129790,818,6493,Southwest Airlines,ORD,MKE
SW109,1695143370,1695144208,838,18687,Southwest Airlines,MKE,SFO
SW109,1695173374,1695175593,2219,6402,Southwest Airlines,SFO,ORD
SW109,1695191851,1695192119,268,7204,Southwest Airlines,ORD,MKE
SW109,1695206152,1695210005,3853,14304,Southwest Airlines,MKE,ORD
SW109,1695228809,1695228827,18,4208,Southwest Airlines,ORD,MKE
SW109,1695238892,1695240552,1660,4566,Southwest Airlines,MKE,SFO
SW109,1695248780,1695252307,3527,10445,Southwest Airlines,SFO,ORD
SW109,1695264269,1695265716,1447,17947,Southwest Airlines,ORD,MKE
SW109,1695289892,1695297679,7787,18923,Southwest Airlines,MKE,ORD
SW109,1695322731,1695323651,920,6400,Southwest Airlines,ORD,MKE
SW109,1695334126,1695344018,9892,9502,Southwest Airlines,MKE,ORD
SW109,1695359115,1695360617,1502,17066,Southwest Airlines,ORD,MKE
SW109,1695387676,1695389382,1706,7553,Southwest Airlines,MKE,SFO
SW109,1695398987,1695403769,4782,15849,Southwest Airlines,SFO,ORD
SW109,1695423038,1695424488,1450,16464,Southwest Airlines,ORD,MKE
SW109,1695445371,1695446058,687,21203,Southwest Airlines,MKE,SFO
SW109,1695471818,1695473448,1630,3648,Southwest Airlines,SFO,LAX
SW109,1695478228,1695479094,866,15239,Southwest Airlines,LAX,SFO
SW109,1695503342,1695503959,617,4306,Southwest Airlines,SFO,LAX
SW109,1695510751,1695520313,9562,11391,Southwest Airlines,LAX,ORD
SW109,1695531743,1695532505,762,16566,Southwest Airlines,ORD,MKE
SW109,1695559275,1695560986,1711,8160,Southwest Airlines,MKE,SFO
SW109,1695578294,1695579813,1519,13606,Southwest Airlines,SFO,LAX
SW109,1695593892,1695595751,1859,19199,Southwest Airlines,LAX,ORD
SW109,1695620928,1695621159,231,10287,Southwest Airlines,ORD,MKE
SW109,1695632452,1695633630,1178,17416,Southwest Airlines,MKE,LAX
SW109,1695661582,1695662808,1226,12485,Southwest Airlines,LAX,SFO
SW109,1695684554,1695686956,2402,8420,Southwest Airlines,SFO,ORD
SW109,1695697799,1695697850,51,21459,Southwest Airlines,ORD,MKE
SW109,1695723086,1695724059,973,12572,Southwest Airlines,MKE,LAX
SW109,1695739548,1695740332,784,6938,Southwest Airlines,LAX,SFO
SW109,1695754530,1695760602,6072,18347,Southwest Airlines,SFO,ORD
SW109,1695788808,1695790324,1516,14469,Southwest Airlines,ORD,MKE
SW109,1695807932,1695809617,1685,18758,Southwest Airlines,MKE,SFO
SW109,1695830619,1695831015,396,18722,Southwest Airlines,SFO,LAX
SW109,1695857561,1695858705,1144,17497,Southwest Airlines,LAX,SFO
SW109,1695880259,1695890603,10344,13478,Southwest Airlines,SFO,ORD
SW109,1695904395,1695904686,291,6980,Southwest Airlines,ORD,MKE
SW109,1695919133,1695921849,2716,14527,Southwest Airlines,MKE,ORD
SW109,1695944258,1695944678,420,9043,Southwest Airlines,ORD,MKE
SW109,1695956587,1695957765,1178,7824,Southwest Airlines,MKE,LAX
SW109,1695973543,1695984331,10788,4230,Southwest Airlines,LAX,ORD
SW109,1695990749,1695992495,1746,5512,Southwest Airlines,ORD,MKE
SW109,1696008213,1696015845,7632,14750,Southwest Airlines,MKE,ORD
SW109,1696033503,1696034434,931,17756,Southwest Airlines,ORD,MKE
SW109,1696052844,1696053996,1152,15568,Southwest Airlines,MKE,LAX
SW109,1696074435,1696083056,8621,19912,Southwest Airlines,LAX,ORD
SW109,1696106726,1696106896,170,4428,Southwest Airlines,ORD,MKE
SW109,1696117816,1696124956,7140,6559,Southwest Airlines,MKE,ORD
SW109,1696133098,1696133818,720,9046,Southwest Airlines,ORD,MKE
SW109,1696143922,1696145656,1734,6770,Southwest Airlines,MKE,SFO
SW109,1696162482,1696163083,601,7454,Southwest Airlines,SFO,LAX
SW109,1696174359,1696178933,4574,16582,Southwest Airlines,LAX,ORD
SW109,1696200936,1696201210,274,4246,Southwest Airlines,ORD,MKE
SW109,1696212209,1696213099,890,11236,Southwest Airlines,MKE,SFO
SW109,1696226323,1696232515,6192,11352,Southwest Airlines,SFO,ORD
SW109,1696249412,1696249454,42,16772,Southwest Airlines,ORD,MKE
SW109,1696268994,1696276744,7750,4575,Southwest Airlines,MKE,ORD
SW109,1696283407,1696285157,1750,7359,Southwest Airlines,ORD,MKE
SW109,1696300073,1696301460,1387,5800,Southwest Airlines,MKE,SFO
SW109,1696315128,1696317034,1906,9048,Southwest Airlines,SFO,ORD
SW109,1696335153,1696336708,1555,3861,Southwest Airlines,ORD,MKE
SW109,1696341071,1696341880,809,17511,Southwest Airlines,MKE,LAX
SW109,1696366725,1696371038,4313,14016,Southwest Airlines,LAX,ORD
SW109,1696392161,1696392185,24,4663,Southwest Airlines,ORD,MKE
SW109,1696403278,1696404380,1102,10159,Southwest Airlines,MKE,SFO
SW109,1696423058,1696424408,1350,11545,Southwest Airlines,SFO,LAX
SW109,1696443684,1696444725,1041,20334,Southwest Airlines,LAX,SFO
SW109,1696473914,1696484311,10397,17562,Southwest Airlines,SFO,ORD
SW109,1696507978,1696508760,782,4579,Southwest Airlines,ORD,MKE
SW109,1696514783,1696514784,1,17458,Southwest Airlines,MKE,SFO
SW109,1696538966,1696539133,167,20888,Southwest Airlines,SFO,LAX
SW109,1696568798,1696574296,5498,15298,Southwest Airlines,LAX,ORD
SW109,1696590787,1696592311,1524,3834,Southwest Airlines,ORD,MKE
SW109,1696597174,1696598628,1454,18896,Southwest Airlines,MKE,LAX
SW109,1696618473,1696619706,1233,8021,Southwest Airlines,LAX,SFO
SW109,1696638097,1696639429,1332,7565,Southwest Airlines,SFO,LAX
SW109,1696650797,1696655066,4269,15881,Southwest Airlines,LAX,ORD
SW109,1696673614,1696674355,741,9680,Southwest Airlines,ORD,MKE
SW109,1696686409,1696690083,3674,19967,Southwest Airlines,MKE,ORD
SW109,1696714899,1696715031,132,14653,Southwest Airlines,ORD,MKE
SW109,1696740045,1696741398,1353,9011,Southwest Airlines,MKE,LAX
SW109,1696751910,1696752603,693,20294,Southwest Airlines,LAX,SFO
SW109,1696776098,1696776100,2,14940,Southwest Airlines,SFO,LAX
SW109,1696800203,1696800573,370,16187,Southwest Airlines,LAX,SFO
SW109,1696817102,1696818633,1531,20819,Southwest Airlines,SFO,LAX
SW109,1696847647,1696848270,623,5616,Southwest Airlines,LAX,SFO
SW109,1696854625,1696855710,1085,15069,Southwest Airlines,SFO,LAX
SW109,1696872327,1696874722,2395,7112,Southwest Airlines,LAX,ORD
SW109,1696888864,1696890057,1193,12637,Southwest Airlines,ORD,MKE
SW109,1696908115,1696909715,1600,8471,Southwest Airlines,MKE,SFO
SW109,1696928354,1696929886,1532,4390,Southwest Airlines,SFO,LAX
SW109,1696938984,1696940541,1557,9157,Southwest Airlines,LAX,SFO
SW109,1696954126,1696955178,1052,13059,Southwest Airlines,SFO,LAX
SW109,1696975447,1696984195,8748,19611,Southwest Airlines,LAX,ORD
SW109,1697006904,1697008311,1407,11090,Southwest Airlines,ORD,MKE
SW109,1697019865,1697020322,457,15622,Southwest Airlines,MKE,LAX
SW109,1697041287,1697052044,10757,16989,Southwest Airlines,LAX,ORD
SW109,1697079568,1697080597,1029,6779,Southwest Airlines,ORD,MKE
SW109,1697097269,1697098583,1314,8693,Southwest Airlines,MKE,LAX
SW109,1697107302,1697107667,365,13345,Southwest Airlines,LAX,SFO
SW109,1697124472,1697125205,733,11557,Southwest Airlines,SFO,LAX
SW109,1697137532,1697138447,915,9495,Southwest Airlines,LAX,SFO
SW109,1697156404,1697157836,1432,18975,Southwest Airlines,SFO,LAX
SW109,1697179300,1697180690,1390,10732,Southwest Airlines,LAX,SFO
SW109,1697192840,1697196176,3336,5484,Southwest Airlines,SFO,ORD
SW109,1697202720,1697203810,1090,19190,Southwest Airlines,ORD,MKE
SW109,1697229375,1697230810,1435,14517,Southwest Airlines,MKE,SFO
SW109,1697248375,1697257727,9352,6018,Southwest Airlines,SFO,ORD
SW109,1697273134,1697274637,1503,21017,Southwest Airlines,ORD,MKE
SW109,1697305101,1697306828,1727,3777,Southwest Airlines,MKE,LAX
SW109,1697320865,1697322626,1761,18317,Southwest Airlines,LAX,SFO
SW109,1697351581,1697353023,1442,16138,Southwest Airlines,SFO,LAX
SW109,1697371716,1697379474,7758,8368,Southwest Airlines,LAX,ORD
SW109,1697393797,1697395546,1749,4804,Southwest Airlines,ORD,MKE
SW109,1697400584,1697401977,1393,11126,Southwest Airlines,MKE,SFO
SW109,1697415182,1697416206,1024,17235,Southwest Airlines,SFO,LAX
SW109,1697436598,1697437186,588,9012,Southwest Airlines,LAX,SFO
SW109,1697453569,1697453672,103,12026,Southwest Airlines,SFO,LAX
SW109,1697469194,1697472076,2882,14216,Southwest Airlines,LAX,ORD
SW109,1697492693,1697493714,1021,14615,Southwest Airlines,ORD,MKE
SW109,1697511093,1697512968,1875,13833,Southwest Airlines,MKE,ORD
SW109,1697529994,1697530521,527,7393,Southwest Airlines,ORD,MKE
SW109,1697542653,1697544399,1746,10156,Southwest Airlines,MKE,LAX
SW109,1697555579,1697558953,3374,13298,Southwest Airlines,LAX,ORD
SW109,1697574605,1697576159,1554,21588,Southwest Airlines,ORD,MKE
SW109,1697601657,1697602835,1178,14320,Southwest Airlines,MKE,LAX
SW109,1697625335,1697627067,1732,7448,Southwest Airlines,LAX,SFO
SW109,1697642960,1697649029,6069,21210,Southwest Airlines,SFO,ORD
SW109,1697670849,1697671062,213,9551,Southwest Airlines,ORD,MKE
SW109,1697683840,1697684380,540,16164,Southwest Airlines,MKE,LAX
SW109,1697700745,1697706809,6064,12074,Southwest Airlines,LAX,ORD
SW109,1697727203,1697727391,188,8231,Southwest Airlines,ORD,MKE
SW109,1697738717,1697740330,1613,15030,Southwest Airlines,MKE,SFO
SW109,1697758905,1697759766,861,18119,Southwest Airlines,SFO,LAX
SW109,1697788232,1697789937,1705,21541,Southwest Airlines,LAX,SFO
SW109,1697811923,1697822387,10464,13695,Southwest Airlines,SFO,ORD
SW109,1697836937,1697838106,1169,4751,Southwest Airlines,ORD,MKE
SW109,1697852553,1697853279,726,6599,Southwest Airlines,MKE,LAX
SW109,1697863676,1697865415,1739,9119,Southwest Airlines,LAX,SFO
SW109,1697875725,1697876489,764,14777,Southwest Airlines,SFO,LAX
SW109,1697897065,1697897687,622,20443,Southwest Airlines,LAX,SFO
SW109,1697921804,1697925417,3613,12136,Southwest Airlines,SFO,ORD
SW109,1697942592,1697943625,1033,13284,Southwest Airlines,ORD,MKE
SW109,1697962723,1697963714,991,7297,Southwest Airlines,MKE,SFO
SW109,1697980910,1697987095,6185,6252,Southwest Airlines,SFO,ORD
SW109,1698002751,1698003015,264,10702,Southwest Airlines,ORD,MKE
SW109,1698013872,1698022744,8872,10471,Southwest Airlines,MKE,ORD
SW109,1698041527,1698041924,397,16533,Southwest Airlines,ORD,MKE
SW109,1698067119,1698068273,1154,18593,Southwest Airlines,MKE,LAX
SW109,1698087973,1698088317,344,7315,Southwest Airlines,LAX,SFO
SW109,1698099159,1698107469,8310,6815,Southwest Airlines,SFO,ORD
SW109,1698116623,1698117888,1265,5964,Southwest Airlines,ORD,MKE
SW109,1698125709,1698126778,1069,13180,Southwest Airlines,MKE,LAX
SW109,1698144563,1698145323,760,17647,Southwest Airlines,LAX,SFO
SW109,1698166180,1698167461,1281,9092,Southwest Airlines,SFO,LAX
SW109,1698181230,1698190866,9636,15069,Southwest Airlines,LAX,ORD
SW109,1698213005,1698213872,867,12529,Southwest Airlines,ORD,MKE
SW109,1698230236,1698231693,1457,13539,Southwest Airlines,MKE,LAX
SW109,1698254504,1698254926,422,6603,Southwest Airlines,LAX,SFO
SW109,1698262735,1698268485,5750,12952,Southwest Airlines,SFO,ORD
SW109,1698289453,1698290093,640,8221,Southwest Airlines,ORD,MKE
SW109,1698305629,1698305962,333,4237,Southwest Airlines,MKE,LAX
SW109,1698318482,1698320539,2057,14367,Southwest Airlines,LAX,ORD
SW109,1698341850,1698342684,834,11453,Southwest Airlines,ORD,MKE
SW109,1698357922,1698364927,7005,6800,Southwest Airlines,MKE,ORD
SW109,1698377185,1698378265,1080,19679,Southwest Airlines,ORD,MKE
SW109,1698405662,1698415795,10133,6874,Southwest Airlines,MKE,ORD
SW109,1698426624,1698427021,397,6151,Southwest Airlines,ORD,MKE
SW109,1698443598,1698444155,557,10530,Southwest Airlines,MKE,LAX
SW109,1698456302,1698466225,9923,20452,Southwest Airlines,LAX,ORD
SW109,1698490452,1698491141,689,17447,Southwest Airlines,ORD,MKE
UA720,1682959659,1682968815,9156,18785,United Airlines,MKE,LAX
UA720,1682997467,1683006882,9415,19977,United Airlines,LAX,ORD
UA720,1683028519,1683033848,5329,17440,United Airlines,ORD,MKE
UA720,1683058792,1683064924,6132,18298,United Airlines,MKE,SFO
UA720,1683092122,1683097836,5714,21444,United Airlines,SFO,LAX
UA720,1683120805,1683131469,10664,19104,United Airlines,LAX,SFO
UA720,1683152246,1683161727,9481,14022,United Airlines,SFO,LAX
UA720,1683185504,1683192090,6586,7584,United Airlines,LAX,ORD
UA720,1683201350,1683210497,9147,14412,United Airlines,ORD,MKE
UA720,1683232977,1683241852,8875,14825,United Airlines,MKE,ORD
UA720,1683263480,1683272166,8686,12187,United Airlines,ORD,MKE
UA720,1683293323,1683297975,4652,16511,United Airlines,MKE,SFO
UA720,1683324048,1683333451,9403,13518,United Airlines,SFO,LAX
UA720,1683357473,1683367442,9969,14100,United Airlines,LAX,ORD
UA720,1683388952,1683393003,4051,5246,United Airlines,ORD,MKE
UA720,1683408297,1683416000,7703,4816,United Airlines,MKE,LAX
UA720,1683430714,1683441472,10758,5924,United Airlines,LAX,ORD
UA720,1683451341,1683457255,5914,11379,United Airlines,ORD,MKE
UA720,1683473347,1683476843,3496,18559,United Airlines,MKE,LAX
UA720,1683503668,1683506096,2428,16393,United Airlines,LAX,ORD
UA720,1683526819,1683532683,5864,14583,United Airlines,ORD,MKE
UA720,1683548732,1683551409,2677,4872,United Airlines,MKE,LAX
UA720,1683567013,1683569579,2566,19727,United Airlines,LAX,ORD
UA720,1683594963,1683602840,7877,8220,United Airlines,ORD,MKE
UA720,1683611941,1683617529,5588,17063,United Airlines,MKE,ORD
UA720,1683644323,1683652447,8124,10224,United Airlines,ORD,MKE
UA720,1683663296,1683670669,7373,6610,United Airlines,MKE,LAX
UA720,1683685267,1683688337,3070,4984,United Airlines,LAX,SFO
UA720,1683701966,1683707843,5877,5303,United Airlines,SFO,ORD
UA720,1683714208,1683718624,4416,8543,United Airlines,ORD,MKE
UA720,1683732768,1683742646,9878,10740,United Airlines,MKE,LAX
UA720,1683760508,1683765262,4754,17890,United Airlines,LAX,ORD
UA720,1683792618,1683796612,3994,10753,United Airlines,ORD,MKE
UA720,1683812004,1683815229,3225,9448,United Airlines,MKE,ORD
UA720,1683826107,1683831440,5333,20040,United Airlines,ORD,MKE
UA720,1683852513,1683861165,8652,4448,United Airlines,MKE,SFO
UA720,1683868392,1683872730,4338,11835,United Airlines,SFO,LAX
UA720,1683888168,1683894649,6481,19634,United Airlines,LAX,ORD
UA720,1683917892,1683925394,7502,12518,United Airlines,ORD,MKE
UA720,1683941848,1683947260,5412,20145,United Airlines,MKE,ORD
UA720,1683973866,1683981264,7398,16453,United Airlines,ORD,MKE
UA720,1684007463,1684011290,3827,11802,United Airlines,MKE,SFO
UA720,1684028071,1684035491,7420,7464,United Airlines,SFO,ORD
UA720,1684047112,1684049054,1942,9419,United Airlines,ORD,MKE
UA720,1684066473,1684069644,3171,15254,United Airlines,MKE,ORD
UA720,1684092602,1684098402,5800,19036,United Airlines,ORD,MKE
UA720,1684127814,1684131898,4084,20427,United Airlines,MKE,ORD
UA720,1684160746,1684167759,7013,7124,United Airlines,ORD,MKE
UA720,1684175149,1684181834,6685,9929,United Airlines,MKE,LAX
UA720,1684197980,1684205771,7791,19558,United Airlines,LAX,SFO
UA720,1684230196,1684239054,8858,5922,United Airlines,SFO,LAX
UA720,1684252188,1684255886,3698,8660,United Airlines,LAX,SFO
UA720,1684264855,1684269499,4644,9234,United Airlines,SFO,ORD
UA720,1684286337,1684296306,9969,10556,United Airlines,ORD,MKE
UA720,1684315020,1684319743,4723,7548,United Airlines,MKE,ORD
UA720,1684336308,1684344923,8615,9055,United Airlines,ORD,MKE
UA720,1684356091,1684362627,6536,10324,United Airlines,MKE,ORD
UA720,1684377078,1684384810,7732,18893,United Airlines,ORD,MKE
UA720,1684405835,1684409068,3233,15062,United Airlines,MKE,ORD
UA720,1684431197,1684440216,9019,11878,United Airlines,ORD,MKE
UA720,1684458997,1684465446,6449,8625,United Airlines,MKE,LAX
UA720,1684482520,1684490418,7898,12873,United Airlines,LAX,SFO
UA720,1684512562,1684516201,3639,3749,United Airlines,SFO,LAX
UA720,1684527712,1684530403,2691,5163,United Airlines,LAX,SFO
UA720,1684536795,1684545697,8902,20040,United Airlines,SFO,LAX
UA720,1684565784,1684571316,5532,7895,United Airlines,LAX,SFO
UA720,1684586980,1684591956,4976,21347,United Airlines,SFO,LAX
UA720,1684615567,1684619809,4242,16432,United Airlines,LAX,SFO
UA720,1684639159,1684646085,6926,8812,United Airlines,SFO,ORD
UA720,1684664118,1684674494,10376,4727,United Airlines,ORD,MKE
UA720,1684680819,1684689826,9007,3798,United Airlines,MKE,ORD
UA720,1684699055,1684701386,2331,10893,United Airlines,ORD,MKE
UA720,1684719566,1684728099,8533,19171,United Airlines,MKE,ORD
UA720,1684755553,1684765864,10311,13368,United Airlines,ORD,MKE
UA720,1684783941,1684786410,2469,12576,United Airlines,MKE,ORD
UA720,1684806627,1684809266,2639,17716,United Airlines,ORD,MKE
UA720,1684835184,1684844836,9652,19945,United Airlines,MKE,LAX
UA720,1684870029,1684873130,3101,3842,United Airlines,LAX,ORD
UA720,1684880962,1684888732,7770,3745,United Airlines,ORD,MKE
UA720,1684893109,1684902339,9230,15425,United Airlines,MKE,SFO
UA720,1684919720,1684924104,4384,16781,United Airlines,SFO,ORD
UA720,1684948260,1684950500,2240,3985,United Airlines,ORD,MKE
UA720,1684961307,1684967883,6576,16604,United Airlines,MKE,ORD
UA720,1684989149,1684997484,8335,13530,United Airlines,ORD,MKE
UA720,1685011440,1685019512,8072,20126,United Airlines,MKE,ORD
UA720,1685048686,1685056115,7429,15830,United Airlines,ORD,MKE
UA720,1685078106,1685085842,7736,20576,United Airlines,MKE,LAX
UA720,1685108980,1685113337,4357,12263,United Airlines,LAX,ORD
UA720,1685129035,1685139144,10109,14436,United Airlines,ORD,MKE
UA720,1685156698,1685166407,9709,4821,United Airlines,MKE,LAX
UA720,1685180940,1685186970,6030,6328,United Airlines,LAX,SFO
UA720,1685196961,1685200634,3673,11769,United Airlines,SFO,LAX
UA720,1685215388,1685220199,4811,15398,United Airlines,LAX,SFO
UA720,1685237919,1685244374,6455,5825,United Airlines,SFO,LAX
UA720,1685250842,1685254598,3756,4122,United Airlines,LAX,ORD
UA720,1685269168,1685272315,3147,9116,United Airlines,ORD,MKE
UA720,1685291775,1685296885,5110,14184,United Airlines,MKE,LAX
UA720,1685311590,1685314388,2798,11903,United Airlines,LAX,SFO
UA720,1685335390,1685343330,7940,11902,United Airlines,SFO,ORD
UA720,1685361678,1685368485,6807,12868,United Airlines,ORD,MKE
UA720,1685389425,1685391250,1825,7934,United Airlines,MKE,LAX
UA720,1685408425,1685415827,7402,17255,United Airlines,LAX,SFO
UA720,1685434817,1685441790,6973,5602,United Airlines,SFO,LAX
UA720,1685457072,1685463503,6431,3880,United Airlines,LAX,ORD
UA720,1685474275,1685482613,8338,19417,United Airlines,ORD,MKE
UA720,1685510866,1685518618,7752,5371,United Airlines,MKE,SFO
UA720,1685528820,1685531946,3126,19842,United Airlines,SFO,LAX
UA720,1685557442,1685561267,3825,19723,United Airlines,LAX,SFO
UA720,1685589841,1685592511,2670,18488,United Airlines,SFO,ORD
UA720,1685611315,1685619411,8096,13504,United Airlines,ORD,MKE
UA720,1685638959,1685643454,4495,17460,United Airlines,MKE,ORD
UA720,1685663445,1685667552,4107,5635,United Airlines,ORD,MKE
UA720,1685675425,1685680528,5103,5718,United Airlines,MKE,ORD
UA720,1685689931,1685692776,2845,16210,United Airlines,ORD,MKE
UA720,1685718916,1685726742,7826,11048,United Airlines,MKE,SFO
UA720,1685738645,1685748692,10047,15138,United Airlines,SFO,ORD
UA720,1685768136,1685773733,5597,19352,United Airlines,ORD,MKE
UA720,1685802517,1685811643,9126,10841,United Airlines,MKE,SFO
UA720,1685822514,1685829937,7423,7430,United Airlines,SFO,ORD
UA720,1685844803,1685850618,5815,6919,United Airlines,ORD,MKE
UA720,1685861277,1685864088,2811,19305,United Airlines,MKE,ORD
UA720,1685885396,1685889501,4105,6339,United Airlines,ORD,MKE
UA720,1685897122,1685899471,2349,6360,United Airlines,MKE,LAX
UA720,1685909743,1685914536,4793,18669,United Airlines,LAX,ORD
UA720,1685939569,1685949948,10379,15733,United Airlines,ORD,MKE
UA720,1685974375,1685978205,3830,21371,United Airlines,MKE,ORD
UA720,1686000303,1686006093,5790,15082,United Airlines,ORD,MKE
UA720,1686021237,1686026502,5265,19184,United Airlines,MKE,SFO
UA720,1686051450,1686058721,7271,12549,United Airlines,SFO,ORD
UA720,1686072274,1686081364,9090,9904,United Airlines,ORD,MKE
UA720,1686100098,1686106394,6296,14527,United Airlines,MKE,ORD
UA720,1686123808,1686129563,5755,14545,United Airlines,ORD,MKE
UA720,1686154669,1686158131,3462,14962,United Airlines,MKE,SFO
UA720,1686183232,1686193525,10293,13326,United Airlines,SFO,LAX
UA720,1686214119,1686217509,3390,11223,United Airlines,LAX,SFO
UA720,1686233811,1686242092,8281,12437,United Airlines,SFO,ORD
UA720,1686257539,1686261405,3866,20087,United Airlines,ORD,MKE
UA720,1686286024,1686296292,10268,19637,United Airlines,MKE,SFO
UA720,1686318440,1686328013,9573,14562,United Airlines,SFO,LAX
UA720,1686347209,1686351866,4657,13649,United Airlines,LAX,SFO
UA720,1686375798,1686382633,6835,9578,United Airlines,SFO,ORD
UA720,1686397502,1686400768,3266,4604,United Airlines,ORD,MKE
UA720,1686413377,1686418702,5325,14892,United Airlines,MKE,SFO
UA720,1686436931,1686446235,9304,7022,United Airlines,SFO,LAX
UA720,1686457998,1686468000,10002,10515,United Airlines,LAX,ORD
UA720,1686481506,1686490801,9295,17567,United Airlines,ORD,MKE
UA720,1686508914,1686514877,5963,4252,United Airlines,MKE,LAX
UA720,1686527224,1686535841,8617,19311,United Airlines,LAX,ORD
UA720,1686559282,1686561540,2258,8137,United Airlines,ORD,MKE
UA720,1686578544,1686582032,3488,10682,United Airlines,MKE,ORD
UA720,1686596298,1686607061,10763,20586,United Airlines,ORD,MKE
UA720,1686631961,1686639660,7699,17462,United Airlines,MKE,SFO
UA720,1686659627,1686670411,10784,10613,United Airlines,SFO,ORD
UA720,1686682004,1686688618,6614,20058,United Airlines,ORD,MKE
UA720,1686718140,1686728735,10595,10880,United Airlines,MKE,LAX
UA720,1686741289,1686743730,2441,8395,United Airlines,LAX,SFO
UA720,1686758917,1686767664,8747,20567,United Airlines,SFO,ORD
UA720,1686792824,1686799262,6438,6663,United Airlines,ORD,MKE
UA720,1686812771,1686817715,4944,17928,United Airlines,MKE,LAX
UA720,1686844379,1686847293,2914,9155,United Airlines,LAX,ORD
UA720,1686862740,1686869028,6288,7509,United Airlines,ORD,MKE
UA720,1686881967,1686886764,4797,4790,United Airlines,MKE,LAX
UA720,1686897991,1686904890,6899,20539,United Airlines,LAX,ORD
UA720,1686931712,1686942091,10379,8358,United Airlines,ORD,MKE
UA720,1686960291,1686968423,8132,6964,United Airlines,MKE,SFO
UA720,1686983485,1686988041,4556,9109,United Airlines,SFO,ORD
UA720,1686999868,1687007225,7357,10618,United Airlines,ORD,MKE
UA720,1687020193,1687024998,4805,19332,United Airlines,MKE,ORD
UA720,1687045451,1687054326,8875,7645,United Airlines,ORD,MKE
UA720,1687065311,1687071417,6106,21429,United Airlines,MKE,LAX
UA720,1687092974,1687096596,3622,21227,United Airlines,LAX,SFO
UA720,1687120798,1687127843,7045,9171,United Airlines,SFO,LAX
UA720,1687139018,1687147404,8386,11300,United Airlines,LAX,SFO
UA720,1687168801,1687178652,9851,10139,United Airlines,SFO,LAX
UA720,1687192345,1687195255,2910,20929,United Airlines,LAX,ORD
UA720,1687219686,1687227783,8097,19726,United Airlines,ORD,MKE
UA720,1687257027,1687263495,6468,19430,United Airlines,MKE,SFO
UA720,1687287496,1687296395,8899,8711,United Airlines,SFO,ORD
UA720,1687307246,1687313462,6216,15261,United Airlines,ORD,MKE
UA720,1687338189,1687343648,5459,14951,United Airlines,MKE,SFO
UA720,1687367604,1687370592,2988,18117,United Airlines,SFO,ORD
UA720,1687397642,1687405241,7599,13211,United Airlines,ORD,MKE
UA720,1687420757,1687428830,8073,13224,United Airlines,MKE,SFO
UA720,1687449721,1687454587,4866,10210,United Airlines,SFO,LAX
UA720,1687474469,1687483417,8948,6521,United Airlines,LAX,ORD
UA720,1687500351,1687502905,2554,15925,United Airlines,ORD,MKE
UA720,1687521357,1687531795,10438,6288,United Airlines,MKE,SFO
UA720,1687540575,1687543830,3255,7576,United Airlines,SFO,LAX
UA720,1687555135,1687564274,9139,13628,United Airlines,LAX,ORD
UA720,1687588194,1687598078,9884,6533,United Airlines,ORD,MKE
UA720,1687610174,1687614224,4050,6540,United Airlines,MKE,SFO
UA720,1687624665,1687629586,4921,16770,United Airlines,SFO,LAX
UA720,1687647462,1687655184,7722,18854,United Airlines,LAX,SFO
UA720,1687675430,1687678848,3418,6083,United Airlines,SFO,LAX
UA720,1687691021,1687696601,5580,11689,United Airlines,LAX,SFO
UA720,1687714184,1687718093,3909,11101,United Airlines,SFO,LAX
UA720,1687730338,1687732492,2154,12729,United Airlines,LAX,ORD
UA720,1687748121,1687757033,8912,17918,United Airlines,ORD,MKE
UA720,1687775167,1687780814,5647,15125,United Airlines,MKE,ORD
UA720,1687800200,1687805113,4913,12500,United Airlines,ORD,MKE
UA720,1687825233,1687829669,4436,10711,United Airlines,MKE,LAX
UA720,1687847403,1687851733,4330,10756,United Airlines,LAX,SFO
UA720,1687868245,1687876079,7834,4273,United Airlines,SFO,ORD
UA720,1687887136,1687894614,7478,16413,United Airlines,ORD,MKE
UA720,1687919137,1687923554,4417,13890,United Airlines,MKE,LAX
UA720,1687940948,1687943091,2143,16930,United Airlines,LAX,SFO
UA720,1687960482,1687966642,6160,14570,United Airlines,SFO,ORD
UA720,1687988590,1687990846,2256,11183,United Airlines,ORD,MKE
UA720,1688012020,1688017292,5272,8175,United Airlines,MKE,LAX
UA720,1688035984,1688041602,5618,18508,United Airlines,LAX,SFO
UA720,1688064757,1688072671,7914,13183,United Airlines,SFO,LAX
UA720,1688088596,1688099227,10631,12916,United Airlines,LAX,SFO
UA720,1688119968,1688124231,4263,12897,United Airlines,SFO,ORD
UA720,1688146146,1688151643,5497,8855,United Airlines,ORD,MKE
UA720,1688164542,1688175322,10780,16464,United Airlines,MKE,SFO
UA720,1688201906,1688212499,10593,18627,United Airlines,SFO,ORD
UA720,1688232361,1688238198,5837,11508,United Airlines,ORD,MKE
UA720,1688252811,1688261679,8868,8548,United Airlines,MKE,SFO
UA720,1688270310,1688273462,3152,8650,United Airlines,SFO,LAX
UA720,1688282907,1688290418,7511,14264,United Airlines,LAX,ORD
UA720,1688313530,1688321187,7657,15956,United Airlines,ORD,MKE
UA720,1688339784,1688346042,6258,7359,United Airlines,MKE,ORD
UA720,1688362809,1688367980,5171,11109,United Airlines,ORD,MKE
UA720,1688386296,1688389825,3529,10303,United Airlines,MKE,ORD
UA720,1688408998,1688418449,9451,14476,United Airlines,ORD,MKE
UA720,1688434000,1688438339,4339,11337,United Airlines,MKE,LAX
UA720,1688454216,1688460173,5957,12016,United Airlines,LAX,SFO
UA720,1688478480,1688480334,1854,8342,United Airlines,SFO,LAX
UA720,1688488734,1688496756,8022,19651,United Airlines,LAX,ORD
UA720,1688525922,1688529057,3135,17235,United Airlines,ORD,MKE
UA720,1688549069,1688556562,7493,11738,United Airlines,MKE,SFO
UA720,1688573958,1688584692,10734,8508,United Airlines,SFO,LAX
UA720,1688597446,1688605858,8412,7845,United Airlines,LAX,ORD
UA720,1688623705,1688632919,9214,17550,United Airlines,ORD,MKE
UA720,1688656896,1688660111,3215,9003,United Airlines,MKE,SFO
UA720,1688671118,1688680854,9736,18379,United Airlines,SFO,ORD
UA720,1688702270,1688709368,7098,10982,United Airlines,ORD,MKE
UA720,1688728471,1688730369,1898,12899,United Airlines,MKE,LAX
UA720,1688749430,1688757615,8185,20560,United Airlines,LAX,SFO
UA720,1688782135,1688787550,5415,9034,United Airlines,SFO,ORD
UA720,1688799036,1688803914,4878,18369,United Airlines,ORD,MKE
UA720,1688832335,1688834204,1869,7194,United Airlines,MKE,ORD
UA720,1688851371,1688853691,2320,8837,United Airlines,ORD,MKE
UA720,1688868777,1688875777,7000,10557,United Airlines,MKE,ORD
UA720,1688886667,1688889934,3267,7866,United Airlines,ORD,MKE
UA720,1688902739,1688909063,6324,11616,United Airlines,MKE,ORD
UA720,1688924669,1688932520,7851,10924,United Airlines,ORD,MKE
UA720,1688949013,1688958724,9711,14395,United Airlines,MKE,LAX
UA720,1688977753,1688984312,6559,11360,United Airlines,LAX,SFO
UA720,1688999183,1689005946,6763,14674,United Airlines,SFO,ORD
UA720,1689025852,1689030875,5023,21475,United Airlines,ORD,MKE
UA720,1689053956,1689063438,9482,6384,United Airlines,MKE,ORD
UA720,1689074145,1689077184,3039,6074,United Airlines,ORD,MKE
UA720,1689084409,1689090036,5627,15619,United Airlines,MKE,ORD
UA720,1689110088,1689118498,8410,16121,United Airlines,ORD,MKE
UA720,1689142041,1689150813,8772,5348,United Airlines,MKE,LAX
UA720,1689164379,1689166364,1985,8922,United Airlines,LAX,ORD
UA720,1689177178,1689187575,10397,8573,United Airlines,ORD,MKE
UA720,1689204219,1689207565,3346,7579,United Airlines,MKE,SFO
UA720,1689225155,1689227841,2686,21171,United Airlines,SFO,LAX
UA720,1689257823,1689264803,6980,8699,United Airlines,LAX,ORD
UA720,1689275653,1689280910,5257,14676,United Airlines,ORD,MKE
UA720,1689305739,1689312447,6708,15153,United Airlines,MKE,ORD
UA720,1689328972,1689336615,7643,13171,United Airlines,ORD,MKE
UA720,1689353678,1689361922,8244,15327,United Airlines,MKE,SFO
UA720,1689381600,1689391011,9411,19625,United Airlines,SFO,ORD
UA720,1689412989,1689417352,4363,9847,United Airlines,ORD,MKE
UA720,1689437388,1689442501,5113,13056,United Airlines,MKE,LAX
UA720,1689457825,1689467239,9414,4473,United Airlines,LAX,ORD
UA720,1689481637,1689488357,6720,11863,United Airlines,ORD,MKE
UA720,1689502860,1689510946,8086,6737,United Airlines,MKE,ORD
UA720,1689520168,1689529758,9590,16445,United Airlines,ORD,MKE
UA720,1689548423,1689554401,5978,5914,United Airlines,MKE,LAX
UA720,1689564506,1689573618,9112,14463,United Airlines,LAX,SFO
UA720,1689596558,1689605771,9213,19556,United Airlines,SFO,LAX
UA720,1689625668,1689630134,4466,17957,United Airlines,LAX,SFO
UA720,1689648602,1689652816,4214,5105,United Airlines,SFO,ORD
UA720,1689666527,1689674652,8125,8415,United Airlines,ORD,MKE
UA720,1689689825,1689695259,5434,8014,United Airlines,MKE,ORD
UA720,1689711992,1689717104,5112,13614,United Airlines,ORD,MKE
UA720,1689730898,1689733468,2570,20437,United Airlines,MKE,ORD
UA720,1689762673,1689773373,10700,3688,United Airlines,ORD,MKE
UA720,1689782307,1689785768,3461,4259,United Airlines,MKE,ORD
UA720,1689794542,1689800819,6277,20748,United Airlines,ORD,MKE
UA720,1689829566,1689831782,2216,8791,United Airlines,MKE,SFO
UA720,1689840942,1689843015,2073,15976,United Airlines,SFO,LAX
UA720,1689869283,1689878574,9291,9005,United Airlines,LAX,ORD
UA720,1689889540,1689893225,3685,4166,United Airlines,ORD,MKE
UA720,1689903220,1689907088,3868,16394,United Airlines,MKE,ORD
UA720,1689933181,1689943042,9861,16863,United Airlines,ORD,MKE
UA720,1689969415,1689979240,9825,17470,United Airlines,MKE,SFO
UA720,1690003666,1690009490,5824,4424,United Airlines,SFO,LAX
UA720,1690022973,1690024853,1880,13115,United Airlines,LAX,SFO
UA720,1690041503,1690044798,3295,15758,United Airlines,SFO,ORD
UA720,1690064423,1690074450,10027,18309,United Airlines,ORD,MKE
UA720,1690097956,1690101147,3191,18759,United Airlines,MKE,ORD
UA720,1690124232,1690134907,10675,20580,United Airlines,ORD,MKE
UA720,1690156420,1690165512,9092,9760,United Airlines,MKE,SFO
UA720,1690180001,1690185114,5113,18005,United Airlines,SFO,LAX
UA720,1690212018,1690220196,8178,5747,United Airlines,LAX,SFO
UA720,1690234632,1690241524,6892,7570,United Airlines,SFO,LAX
UA720,1690254589,1690257888,3299,19653,United Airlines,LAX,ORD
UA720,1690281131,1690283909,2778,16234,United Airlines,ORD,MKE
UA720,1690300382,1690303095,2713,18965,United Airlines,MKE,ORD
UA720,1690322839,1690332202,9363,4316,United Airlines,ORD,MKE
UA720,1690346397,1690355544,9147,14369,United Airlines,MKE,ORD
UA720,1690370655,1690374744,4089,3619,United Airlines,ORD,MKE
UA720,1690388693,1690394748,6055,12526,United Airlines,MKE,LAX
UA720,1690408145,1690411533,3388,5357,United Airlines,LAX,ORD
UA720,1690419611,1690426664,7053,11685,United Airlines,ORD,MKE
UA720,1690438513,1690442432,3919,9164,United Airlines,MKE,SFO
UA720,1690459163,1690462572,3409,12574,United Airlines,SFO,ORD
UA720,1690476994,1690479291,2297,8440,United Airlines,ORD,MKE
UA720,1690493097,1690500825,7728,16182,United Airlines,MKE,SFO
UA720,1690525676,1690530415,4739,13026,United Airlines,SFO,LAX
UA720,1690551845,1690559081,7236,7860,United Airlines,LAX,ORD
UA720,1690576235,1690585108,8873,15409,United Airlines,ORD,MKE
UA720,1690603353,1690613431,10078,8007,United Airlines,MKE,ORD
UA720,1690628487,1690634564,6077,20921,United Airlines,ORD,MKE
UA720,1690657670,1690667194,9524,17188,United Airlines,MKE,LAX
UA720,1690686133,1690688321,2188,15059,United Airlines,LAX,SFO
UA720,1690707959,1690716538,8579,11559,United Airlines,SFO,LAX
UA720,1690734079,1690739199,5120,15840,United Airlines,LAX,ORD
UA720,1690758388,1690767378,8990,13427,United Airlines,ORD,MKE
UA720,1690791218,1690794991,3773,8385,United Airlines,MKE,SFO
UA720,1690806485,1690814216,7731,6386,United Airlines,SFO,LAX
UA720,1690830741,1690835964,5223,20625,United Airlines,LAX,SFO
UA720,1690858899,1690867504,8605,11201,United Airlines,SFO,ORD
UA720,1690883273,1690888698,5425,7969,United Airlines,ORD,MKE
UA720,1690899645,1690907961,8316,12536,United Airlines,MKE,SFO
UA720,1690925327,1690935229,9902,11694,United Airlines,SFO,LAX
UA720,1690948618,1690959148,10530,16853,United Airlines,LAX,ORD
UA720,1690976377,1690982801,6424,6341,United Airlines,ORD,MKE
UA720,1690994146,1691000170,6024,7294,United Airlines,MKE,LAX
UA720,1691007679,1691009588,1909,12900,United Airlines,LAX,SFO
UA720,1691024378,1691034371,9993,10496,United Airlines,SFO,ORD
UA720,1691055176,1691061917,6741,6111,United Airlines,ORD,MKE
UA720,1691068197,1691072830,4633,4698,United Airlines,MKE,ORD
UA720,1691082222,1691085640,3418,9726,United Airlines,ORD,MKE
UA720,1691096944,1691104026,7082,18724,United Airlines,MKE,ORD
UA720,1691128584,1691134917,6333,12293,United Airlines,ORD,MKE
UA720,1691155709,1691162088,6379,7115,United Airlines,MKE,LAX
UA720,1691170662,1691174633,3971,5953,United Airlines,LAX,ORD
UA720,1691185648,1691188166,2518,17945,United Airlines,ORD,MKE
UA720,1691215267,1691222786,7519,3820,United Airlines,MKE,LAX
UA720,1691227858,1691235371,7513,16592,United Airlines,LAX,ORD
UA720,1691261288,1691271695,10407,15848,United Airlines,ORD,MKE
UA720,1691294935,1691298216,3281,13642,United Airlines,MKE,ORD
UA720,1691314938,1691316985,2047,13750,United Airlines,ORD,MKE
UA720,1691332778,1691342635,9857,13215,United Airlines,MKE,LAX
UA720,1691365859,1691375685,9826,7612,United Airlines,LAX,SFO
UA720,1691389123,1691392579,3456,11908,United Airlines,SFO,ORD
UA720,1691406067,1691408531,2464,21231,United Airlines,ORD,MKE
UA720,1691429932,1691438133,8201,18421,United Airlines,MKE,LAX
UA720,1691464361,1691471054,6693,12791,United Airlines,LAX,ORD
UA720,1691486900,1691496895,9995,13331,United Airlines,ORD,MKE
UA720,1691515786,1691523317,7531,11924,United Airlines,MKE,ORD
UA720,1691543542,1691551726,8184,19262,United Airlines,ORD,MKE
UA720,1691575921,1691582150,6229,3970,United Airlines,MKE,SFO
UA720,1691590243,1691598351,8108,16611,United Airlines,SFO,ORD
UA720,1691618557,1691621172,2615,12068,United Airlines,ORD,MKE
UA720,1691641999,1691644288,2289,6138,United Airlines,MKE,LAX
UA720,1691658749,1691664065,5316,10849,United Airlines,LAX,ORD
UA720,1691682159,1691686104,3945,8106,United Airlines,ORD,MKE
UA720,1691699134,1691708811,9677,11911,United Airlines,MKE,LAX
UA720,1691722763,1691729711,6948,13165,United Airlines,LAX,SFO
UA720,1691747502,1691749971,2469,20893,United Airlines,SFO,LAX
UA720,1691780008,1691788044,8036,17550,United Airlines,LAX,SFO
UA720,1691805879,1691812129,6250,9147,United Airlines,SFO,ORD
UA720,1691821758,1691824536,2778,10757,United Airlines,ORD,MKE
UA720,1691844666,1691849209,4543,10155,United Airlines,MKE,LAX
UA720,1691867362,1691875022,7660,9076,United Airlines,LAX,SFO
UA720,1691894736,1691900141,5405,17701,United Airlines,SFO,LAX
UA720,1691919554,1691928174,8620,5449,United Airlines,LAX,ORD
UA720,1691942322,1691949770,7448,15561,United Airlines,ORD,MKE
UA720,1691976120,1691985572,9452,8433,United Airlines,MKE,ORD
UA720,1691996140,1692005583,9443,4084,United Airlines,ORD,MKE
UA720,1692013093,1692023228,10135,17128,United Airlines,MKE,LAX
UA720,1692040708,1692043560,2852,15572,United Airlines,LAX,ORD
UA720,1692069896,1692078558,8662,15236,United Airlines,ORD,MKE
UA720,1692097573,1692103911,6338,13051,United Airlines,MKE,LAX
UA720,1692120555,1692124372,3817,18480,United Airlines,LAX,SFO
UA720,1692144302,1692146702,2400,9687,United Airlines,SFO,ORD
UA720,1692164768,1692166834,2066,20343,United Airlines,ORD,MKE
UA720,1692192427,1692195756,3329,11648,United Airlines,MKE,SFO
UA720,1692217722,1692222282,4560,16917,United Airlines,SFO,ORD
UA720,1692248794,1692252932,4138,20555,United Airlines,ORD,MKE
UA720,1692274398,1692285077,10679,10740,United Airlines,MKE,LAX
UA720,1692299209,1692307469,8260,18568,United Airlines,LAX,ORD
UA720,1692327760,1692336338,8578,18663,United Airlines,ORD,MKE
UA720,1692359396,1692366655,7259,20111,United Airlines,MKE,LAX
UA720,1692397197,1692406257,9060,15227,United Airlines,LAX,ORD
UA720,1692428080,1692434248,6168,17305,United Airlines,ORD,MKE
UA720,1692456610,1692462638,6028,15699,United Airlines,MKE,SFO
UA720,1692487984,1692496776,8792,8522,United Airlines,SFO,LAX
UA720,1692514830,1692520708,5878,21535,United Airlines,LAX,SFO
UA720,1692547179,1692554031,6852,9204,United Airlines,SFO,ORD
UA720,1692572689,1692581360,8671,6274,United Airlines,ORD,MKE
UA720,1692591427,1692598654,7227,6183,United Airlines,MKE,LAX
UA720,1692606708,1692609923,3215,9682,United Airlines,LAX,SFO
UA720,1692619937,1692628404,8467,11616,United Airlines,SFO,ORD
UA720,1692641499,1692651816,10317,7573,United Airlines,ORD,MKE
UA720,1692667977,1692673266,5289,5477,United Airlines,MKE,ORD
UA720,1692682911,1692687940,5029,15106,United Airlines,ORD,MKE
UA720,1692711649,1692721928,10279,9285,United Airlines,MKE,LAX
UA720,1692737019,1692743176,6157,14907,United Airlines,LAX,SFO
UA720,1692766917,1692770441,3524,19294,United Airlines,SFO,ORD
UA720,1692796698,1692803586,6888,20978,United Airlines,ORD,MKE
UA720,1692831168,1692839018,7850,17707,United Airlines,MKE,LAX
UA720,1692864670,1692869060,4390,12881,United Airlines,LAX,SFO
UA720,1692891792,1692895540,3748,5901,United Airlines,SFO,ORD
UA720,1692912150,1692916359,4209,10020,United Airlines,ORD,MKE
UA720,1692936580,1692938568,1988,15828,United Airlines,MKE,ORD
UA720,1692962203,1692966938,4735,17642,United Airlines,ORD,MKE
UA720,1692990019,1692995803,5784,9743,United Airlines,MKE,LAX
UA720,1693014938,1693024263,9325,8877,United Airlines,LAX,ORD
UA720,1693039293,1693044859,5566,10982,United Airlines,ORD,MKE
UA720,1693064832,1693070302,5470,11493,United Airlines,MKE,ORD
UA720,1693085936,1693094614,8678,7070,United Airlines,ORD,MKE
UA720,1693110715,1693119811,9096,8893,United Airlines,MKE,LAX
UA720,1693139466,1693145872,6406,20025,United Airlines,LAX,SFO
UA720,1693169469,1693173795,4326,12462,United Airlines,SFO,ORD
UA720,1693189086,1693190997,1911,16044,United Airlines,ORD,MKE
UA720,1693211365,1693215625,4260,5222,United Airlines,MKE,LAX
UA720,1693222731,1693225778,3047,20720,United Airlines,LAX,SFO
UA720,1693253694,1693256012,2318,14723,United Airlines,SFO,ORD
UA720,1693277994,1693283844,5850,5702,United Airlines,ORD,MKE
UA720,1693292820,1693300028,7208,4486,United Airlines,MKE,LAX
UA720,1693315134,1693322724,7590,17370,United Airlines,LAX,ORD
UA720,1693340191,1693348443,8252,4801,United Airlines,ORD,MKE
UA720,1693359118,1693368910,9792,15552,United Airlines,MKE,SFO
UA720,1693389261,1693392114,2853,15899,United Airlines,SFO,LAX
UA720,1693417885,1693421261,3376,9784,United Airlines,LAX,ORD
UA720,1693432173,1693436161,3988,8402,United Airlines,ORD,MKE
UA720,1693449349,1693460102,10753,3820,United Airlines,MKE,LAX
UA720,1693467888,1693472848,4960,11278,United Airlines,LAX,SFO
UA720,1693493082,1693503627,10545,11265,United Airlines,SFO,ORD
UA720,1693516442,1693525111,8669,8749,United Airlines,ORD,MKE
UA720,1693540345,1693548703,8358,6008,United Airlines,MKE,SFO
UA720,1693559652,1693569515,9863,7486,United Airlines,SFO,ORD
UA720,1693583609,1693593348,9739,9369,United Airlines,ORD,MKE
UA720,1693608621,1693614381,5760,6297,United Airlines,MKE,SFO
UA720,1693621533,1693630037,8504,21382,United Airlines,SFO,LAX
UA720,1693653379,1693662603,9224,17019,United Airlines,LAX,SFO
UA720,1693684874,1693694194,9320,8970,United Airlines,SFO,ORD
UA720,1693705987,1693710948,4961,16129,United Airlines,ORD,MKE
UA720,1693732243,1693741709,9466,4865,United Airlines,MKE,LAX
UA720,1693755933,1693758822,2889,13858,United Airlines,LAX,SFO
UA720,1693774076,1693776258,2182,5835,United Airlines,SFO,ORD
UA720,1693792169,1693801372,9203,11575,United Airlines,ORD,MKE
UA720,1693821940,1693824017,2077,5658,United Airlines,MKE,ORD
UA720,1693830152,1693835513,5361,9352,United Airlines,ORD,MKE
UA720,1693854139,1693858250,4111,15213,United Airlines,MKE,LAX
UA720,1693876121,1693879771,3650,13674,United Airlines,LAX,SFO
UA720,1693903277,1693908939,5662,20457,United Airlines,SFO,ORD
UA720,1693937085,1693945042,7957,10449,United Airlines,ORD,MKE
UA720,1693958800,1693964430,5630,13547,United Airlines,MKE,LAX
UA720,1693980867,1693983575,2708,17186,United Airlines,LAX,SFO
UA720,1694003124,1694010993,7869,13263,United Airlines,SFO,LAX
UA720,1694026001,1694033493,7492,5007,United Airlines,LAX,SFO
UA720,1694043652,1694047026,3374,4546,United Airlines,SFO,ORD
UA720,1694061039,1694069632,8593,13032,United Airlines,ORD,MKE
UA720,1694092293,1694096311,4018,11522,United Airlines,MKE,ORD
UA720,1694114205,1694122575,8370,12380,United Airlines,ORD,MKE
UA720,1694142330,1694145194,2864,4142,United Airlines,MKE,SFO
UA720,1694154767,1694160289,5522,5928,United Airlines,SFO,LAX
UA720,1694171481,1694174350,2869,5900,United Airlines,LAX,ORD
UA720,1694189833,1694199718,9885,4021,United Airlines,ORD,MKE
UA720,1694204043,1694207473,3430,16630,United Airlines,MKE,ORD
UA720,1694230544,1694241263,10719,11587,United Airlines,ORD,MKE
UA720,1694260927,1694270793,9866,15960,United Airlines,MKE,SFO
UA720,1694296923,1694300166,3243,15297,United Airlines,SFO,LAX
UA720,1694318825,1694326094,7269,8518,United Airlines,LAX,SFO
UA720,1694337711,1694345797,8086,13238,United Airlines,SFO,ORD
UA720,1694361925,1694363786,1861,15386,United Airlines,ORD,MKE
UA720,1694385610,1694393460,7850,11010,United Airlines,MKE,LAX
UA720,1694408752,1694414804,6052,4785,United Airlines,LAX,ORD
